ӄԓявыԓя риӄукэтэ ивнин ытри ынкы варкыт гынин ӈэвъэн гэԓгыԓин мэмыԓя рагтыгъэ	р и ӄ у к э т э _ # _ ы т р и _ # _ # _ г ы н и н _ ӈ э в ъ э н _ г э ԓ г ы ԓ и н _ # _ # _
ӄԓявыԓ ынкъам купрэн ынанъомрычьын	ы н к ъ а м _ # _ # _
рытэнмавнэн ынӄо эргатык эквэтгъэт копрантыватысӄэквъат	ы н ӄ о _ э р г а т ы к _ э к в э т г ъ э т _ # _
риӄукэтэ гамгаваны нэнайӈоткоӄэн ӄоԓ	г а м г а в а н ы _ # _ ӄ о ԓ _
ԓьунин ынӄо йыӈотконэн	ы н ӄ о _ # _
эвын коԓё	к о ԓ ё _
тыкгаткэта ивнин риӄукэтэ	и в н и н _ р и ӄ у к э т э _
йыӈотконэн эвын коԓё	э в ы н _ к о ԓ ё _
тыкгаткэта	
ивнин риӄукэтэ ынкы	р и ӄ у к э т э _ ы н к ы _
рытваннэнат риӄукэтэ ивнин	р и ӄ у к э т э _ и в н и н _
мачынан ынкы нытваркын ынӄо	ы н к ы _ н ы т в а р к ы н _ # _
эргатык купрэт ёпаннэнат эвын гакваԓен	к у п р э т _ # _ # _ # _
ӈавмэмыԓчыӈын ынӄо рырагтаннэн ынкъам	ы н ӄ о _ р ы р а г т а н н э н _ ы н к ъ а м _
тэнуйгын йыннин	й ы н н и н _
ыттъын ратвынэн рывэнӈынин	р а т в ы н э н _ # _
авынаёԓьэты ԓинԓиӈ йытонэн мэмыԓыткынык рытриԓнин ынӄо ӄԓявыԓ	ԓ и н ԓ и ӈ _ й ы т о н э н _ м э м ы ԓ ы т к ы н ы к _ # _ ы н ӄ о _ ӄ ԓ я в ы ԓ _
ӈытогъэ этъоӄайӄын рэсӄиквъи ԓюур	э т ъ о ӄ а й ӄ ы н _ # _ ԓ ю у р _
рымъэйӈэнин ӄԓявыԓя	ӄ ԓ я в ы ԓ я _
ивнин ивнин ӈэвъэнйыръэ с амыным	и в н и н _ # _ # _ # _
аны ԓыгитэнчимгъуԓьын ӈэвысӄэтӄэй чама	ԓ ы г и т э н ч и м г ъ у ԓ ь ы н _ # _ ч а м а _
ныԓгэнываӈэӄэн ытԓыгэ ытԓьата	ы т ԓ ы г э _ ы т ԓ ь а т а _
ынкъам	
ытԓенъюрык гыԓёо ныԓгыӄин ытԓён энмэн	г ы ԓ ё о _ н ы ԓ г ы ӄ и н _ ы т ԓ ё н _ э н м э н _
ӄуԓинымнымык	
ӄоԓ гатъыԓыӈоԓен ӈэвысӄэтӄэй амыным	г а т ъ ы ԓ ы ӈ о ԓ е н _ # _ а м ы н ы м _
аны ԓыгитэнчимгъуԓьын ӈэвысӄэтӄэй чама ныԓгэнываӈэӄэн ытԓыгэ ытԓьата ынкъам ытԓенъюрык гыԓёо ныԓгыӄин ытԓён ынкыым мэтчымчек нытваӄэн нымнымӄэйык ӄоԓ эӈэӈыԓьын	ԓ ы г и т э н ч и м г ъ у ԓ ь ы н _ # _ ч а м а _ # _ # _ ы т ԓ ь а т а _ # _ ы т ԓ е н ъ ю р ы к _ # _ н ы ԓ г ы ӄ и н _ ы т ԓ ё н _ ы н к ы ы м _ # _ # _ н ы м н ы м ӄ э й ы к _ # _ э ӈ э ӈ ы ԓ ь ы н _
ӄынвэр ытԓыгын иквъи	ы т ԓ ы г ы н _ и к в ъ и _
наӄам ӈутку варкын мэтчымче	ӈ у т к у _ # _ м э т ч ы м ч е _
нымнымӄэйык ԓыӈыр амытва рытъё эӈэӈыԓьын ӈэвъэнэ ивнин юрэӄым нъынмэԓевэннин наӄам	ԓ ы ӈ ы р _ а м ы т в а _ р ы т ъ ё _ э ӈ э ӈ ы ԓ ь ы н _ # _ # _ ю р э ӄ ы м _ # _ # _
ытԓенъюӄэгти нытэргыръоӄэнат ԓиӈвиттэ чакэттэты эквэтгъи	н ы т э р г ы р ъ о ӄ э н а т _ ԓ и ӈ в и т т э _ ч а к э т т э т ы _ э к в э т г ъ и _
ытԓыгын аӈаӈыԓьэты пыкиргъи нымнымӄэйык иквъэт эмитԓёным	а ӈ а ӈ ы ԓ ь э т ы _ # _ н ы м н ы м ӄ э й ы к _ # _ э м и т ԓ ё н ы м _
ынин яраӈы ӄытгъи ӈэнри ярачыкогты рэсӄиквъи ԓюур вай начайпатгъан чайпанмаым нывэтгавчетӄэнат нэнамӈыԓёӄэн рэмкыԓьын	я р а ӈ ы _ ӄ ы т г ъ и _ # _ # _ # _ # _ в а й _ н а ч а й п а т г ъ а н _ # _ н ы в э т г а в ч е т ӄ э н а т _ н э н а м ӈ ы ԓ ё ӄ э н _ # _
мэӈӄо етгъи чаёпԓыткогъат ынӄо эквэтгъэт пыкиргъэт ԓыгэн	е т г ъ и _ ч а ё п ԓ ы т к о г ъ а т _ # _ э к в э т г ъ э т _ п ы к и р г ъ э т _ ԓ ы г э н _
эвыр йъонэн тъытԓьэн эчги	й ъ о н э н _ # _ # _
вуԓӄытвигъи ынраӄ эԓьоткомгой коԓё	ы н р а ӄ _ э ԓ ь о т к о м г о й _ # _
аны ныԓгикэԓьэткуԓьэтӄин чама ԓыгэн ныԓгэярарпэгԓяръоӄэн наӄам тъытԓьэн ыныкгиӈкы нинэнтыӄин эргатык ԓыгинъэ кыеквъи эӈэӈыԓьын	н ы ԓ г и к э ԓ ь э т к у ԓ ь э т ӄ и н _ # _ ԓ ы г э н _ н ы ԓ г э я р а р п э г ԓ я р ъ о ӄ э н _ # _ т ъ ы т ԓ ь э н _ # _ н и н э н т ы ӄ и н _ э р г а т ы к _ # _ # _ э ӈ э ӈ ы ԓ ь ы н _
рыгъевнин тъытԓьэн ынкы вусӄымчыку нэнанпэгԓяръовӄэн	т ъ ы т ԓ ь э н _ ы н к ы _ в у с ӄ ы м ч ы к у _ # _
ԓыгэн икумиӈкыри нинэнтивыӄин	и к у м и ӈ к ы р и _ # _
ынӄо тъэче кивыткугъиым иквъи итыкым	т ъ э ч е _ # _ и к в ъ и _ и т ы к ы м _
вай ԓыгэн ӈэранъыԓё рэмэԓеквъэ нивӄинэт авынраԓьыт вынэ ынан мытрэркурӈын ӄынвэр рагтыгъэ эӈэӈыԓьын авынраԓьа ыныкагты	ԓ ы г э н _ ӈ э р а н ъ ы ԓ ё _ # _ н и в ӄ и н э т _ # _ # _ # _ м ы т р э р к у р ӈ ы н _ # _ р а г т ы г ъ э _ # _ а в ы н р а ԓ ь а _ # _
нэймитын ԓыгэчьыԓьын раквытчыӈын ынкъам ԓымӈэ мооӄор	ԓ ы г э ч ь ы ԓ ь ы н _ р а к в ы т ч ы ӈ ы н _ ы н к ъ а м _ ԓ ы м ӈ э _ м о о ӄ о р _
ынӄоры рэмкын	р э м к ы н _
эраткомгоӈӈой аны таӈэтъо	а н ы _ т а ӈ э т ъ о _
ӈэвысӄэтӄэй гаԓгэтъыԓыӈоԓен тэкэм ԓюур вай эрама	г а ԓ г э т ъ ы ԓ ы ӈ о ԓ е н _ # _ ԓ ю у р _ # _ э р а м а _
въигъи наӄам ӄытԓыги ԓюӈынмэԓевэтэ рыннин	н а ӄ а м _ # _ # _ # _
ынӄоым ынӄэн эӈэӈыԓьын	ы н ӄ э н _ # _
танԓёнръэԓягта гитԓин ԓыгэн таӈӄонпы эвытрыкэ гэнъэтԓин	г и т ԓ и н _ ԓ ы г э н _ т а ӈ ӄ о н п ы _ э в ы т р ы к э _ # _
этъым ԓыгэыяагты гаяԓгытԓен ымто амын ӄэгԓынангэт эты эӈэӈыԓьыт ныԓгинъыръыӄинэт с энмэн нивӄин ынанчинит ынӄэн	ԓ ы г э ы я а г т ы _ # _ ы м т о _ а м ы н _ # _ # _ # _ # _ с _ э н м э н _ н и в ӄ и н _ ы н а н ч и н и т _ # _
гатваԓен тэԓенъеп энмэн нивӄин ынанчинит эвыр	т э ԓ е н ъ е п _ # _ н и в ӄ и н _ ы н а н ч и н и т _ # _
мэӈин ратъыԓыӈоркын	р а т ъ ы ԓ ы ӈ о р к ы н _
ӄэнагтыркынэтык ымыԓьо амӄынъычо	ы м ы ԓ ь о _ а м ӄ ы н ъ ы ч о _
нинивӄинэт ымыԓьо гатакэчгыӄайма ӄитгытык ӄываԓёмгытык ыныкит	ы м ы ԓ ь о _ # _ # _ ӄ ы в а ԓ ё м г ы т ы к _ ы н ы к и т _
ыннэн уйӈэ	у й ӈ э _
этэкичгыӄэйкэ ритгъэ ӄоԓ	р и т г ъ э _ ӄ о ԓ _
ынин ройыръыкэн рэвъигъэ эргатык ӄытръугъэт ымыԓьо гэтэкичгэ гитԓинэт ӄоԓетъыԓё ӄутынин	р о й ы р ъ ы к э н _ # _ э р г а т ы к _ ӄ ы т р ъ у г ъ э т _ # _ г э т э к и ч г э _ # _ ӄ о ԓ е т ъ ы ԓ ё _ # _
экык тъыԓыӈогъэ эргатык	т ъ ы ԓ ы ӈ о г ъ э _ # _
йыннэн	
эӈэӈыԓьын иквъи эӈэӈыԓьэ	и к в ъ и _ э ӈ э ӈ ы ԓ ь э _
ивнин эргатык ӄытгъи эӈэӈыԓьын	э р г а т ы к _ ӄ ы т г ъ и _ э ӈ э ӈ ы ԓ ь ы н _
эвын гъэӄэрэԓин тъытԓьэн	г ъ э ӄ э р э ԓ и н _ # _
атав иԓьуткугъи авынэԓьоткогты въигъи	и ԓ ь у т к у г ъ и _ # _ в ъ и г ъ и _
экык ԓюур	ԓ ю у р _
ытԓыгын иквъи эӈэӈыԓьэ пынԓёнэнат еп гымнан гымнин иԓьуткукэԓы эйӈэвкэ еп	и к в ъ и _ э ӈ э ӈ ы ԓ ь э _ # _ # _ # _ # _ # _ # _ е п _
эпкиркэ въигъи ыныкит нъыпкиргъэн	в ъ и г ъ и _ # _ # _
ӄырым нъывъигъэн этынва пынԓёнэн	н ъ ы в ъ и г ъ э н _ # _ п ы н ԓ ё н э н _
эӈэӈыԓьэ ивнин этынва пынԓёнэн	и в н и н _ # _ п ы н ԓ ё н э н _
эӈэӈыԓьын иквъи ыныкит энамынгыкватка ринэнтыӈ нэмэ ӄоԓ	и к в ъ и _ ы н ы к и т _ # _ # _ н э м э _ ӄ о ԓ _
рэвъигъэ экык	э к ы к _
этынва ивнин мынгыкво йыԓнинэт мытԓыӈэн ӄорат	и в н и н _ м ы н г ы к в о _ # _ м ы т ԓ ы ӈ э н _ # _
ӈирэӄ ыттъыт ӈыроӄ	ы т т ъ ы т _ # _
игнэԓгыт эӈэӈыԓьын рагтыгъэ нэмэ	э ӈ э ӈ ы ԓ ь ы н _ р а г т ы г ъ э _ н э м э _
ӄоԓ экык тъыԓыӈогъэ нэмэ йыннэн эӈэӈыԓьын нэмэ	э к ы к _ # _ # _ й ы н н э н _ # _ # _
ӄытгъи иԓьуткугъи ынкъам иквъи ӄэнамынгыкватгэ пытӄымыкыӈ мынгыкваннэн эквэтгъи	и ԓ ь у т к у г ъ и _ # _ и к в ъ и _ ӄ э н а м ы н г ы к в а т г э _ # _ м ы н г ы к в а н н э н _ э к в э т г ъ и _
эӈэӈыԓьын ԓыгэн эквэтгъи въигъи	ԓ ы г э н _ э к в э т г ъ и _ в ъ и г ъ и _
тъытԓьэн ытԓыгын	ы т ԓ ы г ы н _
иквъи эккэт	э к к э т _
тэԓпыркыт ынраӄ ӈээкык тъыԓыӈогъэ	ы н р а ӄ _ ӈ э э к ы к _ # _
нэмэ	
эӈэӈыԓьын йыннэн	й ы н н э н _
ивнин эӈэӈыԓьын	э ӈ э ӈ ы ԓ ь ы н _
нэмэ ӄытгъи нэмэ иԓьуткугъи	ӄ ы т г ъ и _ н э м э _ и ԓ ь у т к у г ъ и _
иквъи ытԓыгэ	ы т ԓ ы г э _
ивнин этынва	э т ы н в а _
ивнин	
эӈэӈыԓьын иквъи анӈэнайпыгъэ эӈэӈыԓьын	и к в ъ и _ а н ӈ э н а й п ы г ъ э _ # _
эквэтгъи ԓёгмынгыквата ымыԓьо ԓюӈвъитэ	ԓ ё г м ы н г ы к в а т а _ # _ ԓ ю ӈ в ъ и т э _
итгъэт ынӄоры эӈэӈыԓьын эӄу нэтчын	ы н ӄ о р ы _ # _ # _ # _
ымыԓьо нивӄинэт	н и в ӄ и н э т _
ымыԓьорык эӄу нэтчын ынӈин	э ӄ у _ # _ # _
тэԓенъепкин эӈэӈыԓьыт нырагаймычьавӈыӄэнат с ыԓвыԓю эԓек нынмыткоӄэн ипэ	э ӈ э ӈ ы ԓ ь ы т _ # _ с _ ы ԓ в ы ԓ ю _ # _ # _ # _
ӄоԓ итгъэт увиԓьэтгъэт ыԓвытъуԓе	и т г ъ э т _ у в и ԓ ь э т г ъ э т _ # _
ԓыгэн ынкы напэԓянат уӄӄэмчыку эръэйыръын ынкъам	ы н к ы _ н а п э ԓ я н а т _ у ӄ ӄ э м ч ы к у _ э р ъ э й ы р ъ ы н _ ы н к ъ а м _
ыпаԓгын эвын	э в ы н _
етгъэт рэӄэ	р э ӄ э _
ыпаԓгын гаткоӈӈоԓен ымы эръэт гэтъэттывиԓинэт ӄоԓ	г а т к о ӈ ӈ о ԓ е н _ # _ э р ъ э т _ # _ # _
ынээԓьын иквъи кита	и к в ъ и _ к и т а _
ӄоԓ чайвыткоӈӈок ныпэԓятын	ч а й в ы т к о ӈ ӈ о к _ # _
атав гынрыру мыныԓгын	г ы н р ы р у _ # _
ръэнут	
рэркын мури амӄынӈыток	м у р и _ а м ӄ ы н ӈ ы т о к _
ымыԓьо ыԓвэгиԓигъэт ӈыраӄав пэԓятгъэ ынанӈэнчьан	ы ԓ в э г и ԓ и г ъ э т _ # _ п э ԓ я т г ъ э _ ы н а н ӈ э н ч ь а н _
пэԓятыйгот нэнтын тытԓык атчыгъэ ынӄэн оравэтԓьан	н э н т ы н _ т ы т ԓ ы к _ # _ # _ # _
эвын амгынотъыԓё нынъэԓӄин	а м г ы н о т ъ ы ԓ ё _ # _
ԓюур	
ранмэйпык	
вииԓетгъи ԓыгэн ынкы	ԓ ы г э н _ ы н к ы _
эӄуԓикэ нъатчаӄэн эмӄэԓеԓвынэ нивӄин вэчьым	н ъ а т ч а ӄ э н _ # _ # _ в э ч ь ы м _
ӈотӄэн ныетӄин эвын	н ы е т ӄ и н _ # _
рэгъи	
таӈамъыттъымъеквэйӈын ӈэвъэнйыръын авэтываӄ ӄԓявыԓя пэнрынэн аны энмэн гэтэйкэвԓинэт ԓюур амъыттъымъеквэйӈа	ӈ э в ъ э н й ы р ъ ы н _ а в э т ы в а ӄ _ ӄ ԓ я в ы ԓ я _ # _ # _ э н м э н _ г э т э й к э в ԓ и н э т _ # _ # _
авынтайкавэты ивнин йъарат	и в н и н _ й ъ а р а т _
амӄԓявыԓторэ варкынэтык	в а р к ы н э т ы к _
яйвачгыргыторэ	
вэԓерым	
ваӈэԓьо митыркын аны энмэн оравэтԓьаӄай	м и т ы р к ы н _ а н ы _ э н м э н _ о р а в э т ԓ ь а ӄ а й _
гувиԓьэтԓин амъыттъымъеквэйӈын тыргэтъюунин гыргоча	а м ъ ы т т ъ ы м ъ е к в э й ӈ ы н _ т ы р г э т ъ ю у н и н _ г ы р г о ч а _
ыпаԓга	
энайпаннэн ынӄо иквъи	ы н ӄ о _ и к в ъ и _
ӈэвъэнйыръын тагам ораӈанӄо ӄыԓиги ԓыганԓыгъэ	т а г а м _ о р а ӈ а н ӄ о _ # _ ԓ ы г а н ԓ ы г ъ э _
оравэтԓьан 	_
ӈэвъэнйыръэ ивнин эвын	и в н и н _ # _
гитэнин 	_
йыӄӄайъым ӈэвъэнйыръын ынкы	ӈ э в ъ э н й ы р ъ ы н _ # _
гитэнин оравэтԓьата	о р а в э т ԓ ь а т а _
ивнин матанэн еп чейвыткуԓьыт	м а т а н э н _ # _ # _
эпкиркэ увиԓьэтгъи ӈэвъэнйыръын	у в и ԓ ь э т г ъ и _ # _
ԓюур пыкиргъэт ӈыроргарэ ӈытогъэ	п ы к и р г ъ э т _ ӈ ы р о р г а р э _ # _
ӈэвъэнйыръын ԓыгэкоргаквъат ынинэԓьыт рэгъэт чоттагнэты	ԓ ы г э к о р г а к в ъ а т _ ы н и н э ԓ ь ы т _ р э г ъ э т _ ч о т т а г н э т ы _
ынанынпычьа матанэн	м а т а н э н _
ӄоԓ анӈэнайпыгъэ	а н ӈ э н а й п ы г ъ э _
инэԓьуԓьын чейвыткугъэт	ч е й в ы т к у г ъ э т _
нэмэ ӈыроргарэ	ӈ ы р о р г а р э _
ӄоԓ пэԓятгъэ ёрочыко нъэптыӄин ӈэвъэнйыръын	п э ԓ я т г ъ э _ # _ # _ # _
ӄԓявыԓ рэсӄиквъи	р э с ӄ и к в ъ и _
ивнин вынэ	в ы н э _
ӄырым эԓгыӄай эйминнин	э ԓ г ы ӄ а й _ # _
чит выԓгыпыркынэн ԓюур	в ы ԓ г ы п ы р к ы н э н _ ԓ ю у р _
вытры иргъи оравэтԓьан тымнэн ӄытԓыги эӄыԓпэ нэԓгычыку рычымӄэннин кыԓтынин майык	и р г ъ и _ о р а в э т ԓ ь а н _ # _ # _ # _ # _ # _ к ы ԓ т ы н и н _ м а й ы к _
рыннин чейвыткуԓьыт етгъэт	ч е й в ы т к у ԓ ь ы т _ # _
ӈэвъэнйыръын никвъэн	н и к в ъ э н _
ӈэвысӄэтэ ивнинэт	и в н и н э т _
ынръам ӄоԓ пэԓятгъэ ынанынпычьын майгэӈкы	ӄ о ԓ _ п э ԓ я т г ъ э _ # _ # _
ныгатгаткоӄэн ԓюур	ԓ ю у р _
ԓявтэты ръэнут эрэтгъи маԓенэн эвыр	р ъ э н у т _ э р э т г ъ и _ м а ԓ е н э н _ # _
гитэнин мутԓымуԓ иквъи эмӄэԓеԓвынэ	м у т ԓ ы м у ԓ _ # _ # _
ынръам ръэнут нэмэ	р ъ э н у т _ н э м э _
гатгаткоӈӈогъэ нэмэ йиннин мутԓе ӄынвэр	н э м э _ й и н н и н _ # _ ӄ ы н в э р _
наԓгымай рырыткунин 	р ы р ы т к у н и н _ _
эвын ынкы ԓьунин ыргин ытԓеӈи ӄытԓыги	ы н к ы _ ԓ ь у н и н _ ы р г и н _ # _ # _
ӈавъанйыръиӈа ганмыԓен ԓыгэн авъеткынка нэмэ	г а н м ы ԓ е н _ ԓ ы г э н _ # _ н э м э _
румэкэвнин	
ӄутти	
ытԓенъют етгъэт 	е т г ъ э т _ # _
винвэ ивнинэт	и в н и н э т _
ынӄо эргатык ымыԓьо чейвыткугъэт нутэк	э р г а т ы к _ ы м ы ԓ ь о _ ч е й в ы т к у г ъ э т _ # _
увэрайӈын	
нэтэйкын	
аны таӈымъыԓёӈэт гэкымъыгичиԓинэт ԓыгэн	т а ӈ ы м ъ ы ԓ ё ӈ э т _ # _ ԓ ы г э н _
увэрайӈык ныёԓьатӄэнат ӄынвэр ыттъымиԓ майӈаӈӈогъат кымъыгинив нэтэйкын аны таӈымъыԓёӈэт	н ы ё ԓ ь а т ӄ э н а т _ ӄ ы н в э р _ ы т т ъ ы м и ԓ _ # _ к ы м ъ ы г и н и в _ н э т э й к ы н _ а н ы _ т а ӈ ы м ъ ы ԓ ё ӈ э т _
гэкымъыгичиԓинэт	
ԓыгэн увэрайӈык ныёԓьатӄэнат ӄынвэр ыттъымиԓ майӈаӈӈогъат	у в э р а й ӈ ы к _ # _ ӄ ы н в э р _ ы т т ъ ы м и ԓ _ # _
кымъыгинив ынӄо эргатык ӈэвъэнйыръын нываӈэӄэн чотыткынык	ы н ӄ о _ э р г а т ы к _ ӈ э в ъ э н й ы р ъ ы н _ # _ ч о т ы т к ы н ы к _
ԓюур кагынмыткыната ӄочеԓгыԓгыӄай ԓьунин ӈэвъэнйыръын иквъи	к а г ы н м ы т к ы н а т а _ # _ ԓ ь у н и н _ ӈ э в ъ э н й ы р ъ ы н _ # _
ӄочеԓгыԓгыӄай ԓюур иквъи ивкэ ӄун миквыт	ԓ ю у р _ и к в ъ и _ и в к э _ # _ # _
гыныкы нэтэйкын	н э т э й к ы н _
нутэк увэрайӈын ӄэгԓын эргатык чайвытконвэпы	у в э р а й ӈ ы н _ # _ э р г а т ы к _ ч а й в ы т к о н в э п ы _
етык никвъэн ӈэвысӄэтэ ивнинэт виин ӈотӄэнат чемынгыт ӄынчичьэркыниткы кэргымма	н и к в ъ э н _ ӈ э в ы с ӄ э т э _ # _ в и и н _ # _ # _ # _ к э р г ы м м а _
ԓюур эвыр нэгитэн гагыргоԓятԓен нырэпириӈӄин	э в ы р _ # _ # _ # _
ныԓвавӄэн пирик гыргоԓятгъэ	п и р и к _ # _
ӄытԓыги ӄучиԓгыӄэе	ӄ у ч и ԓ г ы ӄ э е _
гангыргоԓявԓен ныпичгыӄин вэгрэтэм	н ы п и ч г ы ӄ и н _ в э г р э т э м _
с ганымыԓьавԓен нынну ынкы вэгрэтэм	г а н ы м ы ԓ ь а в ԓ е н _ # _ ы н к ы _ в э г р э т э м _
аны ытԓён таӈвэнъым ныпичгыӄин	ы т ԓ ё н _ т а ӈ в э н ъ ы м _ # _
тэӈпэнин ӄонратваԓьын ымыӈ	ӄ о н р а т в а ԓ ь ы н _ ы м ы ӈ _
нымным ванэван чымче	в а н э в а н _ # _
нытван миӈкыри	м и ӈ к ы р и _
ӄун найыԓгавӄэн	н а й ы ԓ г а в ӄ э н _
рэԓӄынӈыт мэӈӄокэнат	м э ӈ ӄ о к э н а т _
рэмкыԓьыт кытамчачва	к ы т а м ч а ч в а _
ынкъам ынӄэната	ы н ӄ э н а т а _
найыԓгавӄэн наӄам ытԓён ԓымыԓьын ӈирэнӈэвыԓьын	н а ӄ а м _ # _ ԓ ы м ы ԓ ь ы н _ # _
ытԓён еп	е п _
ԓыгэн аатчек	а а т ч е к _
эквыргъам ԓыгэн гэԓеԓютԓин	ԓ ы г э н _ # _
эвын ԓыгэн гэмэчынпэвыԓгэтԓин	ԓ ы г э н _ г э м э ч ы н п э в ы ԓ г э т ԓ и н _
ӄуԓитгивик ӄоԓ	ӄ о ԓ _
ӈэвъэн рыԓейвынин ӄаагты ынкы	р ы ԓ е й в ы н и н _ # _ ы н к ы _
эвын гагроръоԓен ӄаат эвын	г а г р о р ъ о ԓ е н _ # _ э в ы н _
ныгръоӄэнат	
ӈэнку ӄаатагнык	ӄ а а т а г н ы к _
гытгык ӄача пэнъёԓгын нэтэйкын наӄам ӈэйгиӈкы нытваӄэн	ӄ а ч а _ п э н ъ ё ԓ г ы н _ # _ # _ # _ # _
эвыр	
ӈэԓвыԓ гытоԓыӈкы	г ы т о ԓ ы ӈ к ы _
нытваӄэн тэкэм	т э к э м _
пэтыкэԓвайынвык увэмгогъат	у в э м г о г ъ а т _
ынкы пэтыраԓӄаӈынвык	п э т ы р а ԓ ӄ а ӈ ы н в ы к _
пэтырытын ныԓгинымкыӄин	н ы ԓ г и н ы м к ы ӄ и н _
нарычгытваӄэн ывэӄуч	ы в э ӄ у ч _
ӈэвъэным нувиӄин ынӄо мачгыргоԓягты ӈэвысӄэт уӈэԓгъи ынкы ууркиткугъи	н у в и ӄ и н _ # _ # _ # _ у ӈ э ԓ г ъ и _ # _ у у р к и т к у г ъ и _
ӈэвысӄэт ынӄо	ы н ӄ о _
ываӄочегты ӄытгъи эвтыԓягты нэмэым ӈан нунрэпэтӄин тыԓяма	ӄ ы т г ъ и _ э в т ы ԓ я г т ы _ # _ # _ н у н р э п э т ӄ и н _ # _
наӄам нъэӄэгнитӄин ԓюур вай авынтыԓяма гыткаӄач ԓыгэгтонрапатгъэ ынраӄ	н ъ э ӄ э г н и т ӄ и н _ # _ в а й _ а в ы н т ы ԓ я м а _ г ы т к а ӄ а ч _ # _ ы н р а ӄ _
тиӈук нэнаԓвавӄэн наӄам рай ынкэчыку нинэԓгийгуткуйвыӄин	н э н а ԓ в а в ӄ э н _ н а ӄ а м _ р а й _ ы н к э ч ы к у _ # _
гыткаԓгын рэӄэ ӄынвэр тиӈунин	р э ӄ э _ # _ # _
гыткаӄач эвын ынкы рээн йытонэн ыԓчыкойпы кайӈиӈын	э в ы н _ ы н к ы _ р э э н _ й ы т о н э н _ # _ # _
ԓыгэн ынӄэн гыткак рээн йытонэн ыныкит гитэнин	ы н ӄ э н _ г ы т к а к _ # _ # _ # _ # _
ӈэвысӄэтэ аны гэԓгигынтэвԓин ораываӄочеӈӄачагты наӄам ныԓгиӄуԓиԓьэтӄин аны	а н ы _ # _ # _ н а ӄ а м _ н ы ԓ г и ӄ у ԓ и ԓ ь э т ӄ и н _ # _
вай ръанотайӈоон нэмэым ӈан	р ъ а н о т а й ӈ о о н _ # _ ӈ а н _
нунрэпэтӄин тыԓяма наӄам	т ы ԓ я м а _ н а ӄ а м _
нъэӄэгнитӄин ԓюур вай	ԓ ю у р _ в а й _
авынтыԓяма гыткаӄач	г ы т к а ӄ а ч _
ԓыгэгтонрапатгъэ ынраӄ тиӈук	ы н р а ӄ _ т и ӈ у к _
нэнаԓвавӄэн наӄам рай ынкэчыку	н а ӄ а м _ р а й _ ы н к э ч ы к у _
нинэԓгийгуткуйвыӄин гыткаԓгын рэӄэ	г ы т к а ԓ г ы н _ р э ӄ э _
ӄынвэр тиӈунин	т и ӈ у н и н _
гыткаӄач	
эвын ынкы	ы н к ы _
рээн	
йытонэн ыԓчыкойпы кайӈиӈын ԓыгэн	ы ԓ ч ы к о й п ы _ # _ ԓ ы г э н _
ынӄэн гыткак	г ы т к а к _
рээн йытонэн ыныкит гитэнин ӈэвысӄэтэ аны гэԓгигынтэвԓин ораываӄочеӈӄачагты	й ы т о н э н _ # _ # _ ӈ э в ы с ӄ э т э _ # _ # _ # _
наӄам ныԓгиӄуԓиԓьэтӄин аны вай ръанотайӈоон	н ы ԓ г и ӄ у ԓ и ԓ ь э т ӄ и н _ # _ в а й _ р ъ а н о т а й ӈ о о н _
ӄынвэр ӈан тэӈынпунӈитэвнин кэйӈын	ӈ а н _ т э ӈ ы н п у н ӈ и т э в н и н _ # _
гынтавычгатгъэ	
кайӈиӈын рагтыгъат	р а г т ы г ъ а т _
ытри ынӄо нэмэ эԓеръугъи тыԓванымтакачгыка	ы н ӄ о _ # _ э ԓ е р ъ у г ъ и _ т ы ԓ в а н ы м т а к а ч г ы к а _
ынръа гатваԓен	г а т в а ԓ е н _
ӄоныръым эвын ынӈин эмӄынгивик анымтакачгыка	э в ы н _ ы н ӈ и н _ э м ӄ ы н г и в и к _ # _
нытваӄэн вэгрэтэм	в э г р э т э м _
таӈымыԓьо вээм	в э э м _
ръиԓеръугъи кыткытръогъэ аноԓьатынвык	к ы т к ы т р ъ о г ъ э _ а н о ԓ ь а т ы н в ы к _
тыԓегъи вэгрэтэм	в э г р э т э м _
ӄаанматыԓьатгъэ ынӄо имтиԓӄытгъи ӄааԓьатакватгъэ	ы н ӄ о _ и м т и ԓ ӄ ы т г ъ и _ # _
тыԓвамыргынан	
ӈэвъэнти пэԓянэнат наӄам	п э ԓ я н э н а т _ # _
ӄоԓ	
ӈэвъэн нанӄыԓьын нынныӈыттыӄинэт	н а н ӄ ы ԓ ь ы н _ # _
эԓеӈит юур	ю у р _
рай ӄуԓиныкитэ	ӄ у ԓ и н ы к и т э _
мэԓӄэпы ръэнут нывыргыргыръуӄин наӄам мэԓӄыткынык таӈвэнъым	р ъ э н у т _ н ы в ы р г ы р г ы р ъ у ӄ и н _ # _ м э ԓ ӄ ы т к ы н ы к _ # _
мыгтэкичгыԓьын ынӄо эргатръогъэ нэгитэнэт тэкичгыт	ы н ӄ о _ э р г а т р ъ о г ъ э _ н э г и т э н э т _ т э к и ч г ы т _
аны эвын гэԓгинуйвыԓинэт	э в ы н _ г э ԓ г и н у й в ы ԓ и н э т _
тэкичгыт ынӄо нэмэ	ы н ӄ о _ # _
йыԓӄэтгъэт ӄуԓивуԓӄытвик кыеквъэт	ӄ у ԓ и в у ԓ ӄ ы т в и к _ # _
эвын тэӈуйӈэ	т э ӈ у й ӈ э _
тэкичгыт миԓӄык таӈымыԓьо гэнуйвыԓинэт аны ныԓгайыԓгавӄэнат ӄуԓиныкитэ	м и ԓ ӄ ы к _ # _ г э н у й в ы ԓ и н э т _ # _ н ы ԓ г а й ы ԓ г а в ӄ э н а т _ # _
яракэн рэнмырэм	р э н м ы р э м _
натъайытчагъан	
ԓыгэн нынӄъэӄыръувӄин ӄытԓыги	н ы н ӄ ъ э ӄ ы р ъ у в ӄ и н _ # _
ынӄэнат кэйӈыт	к э й ӈ ы т _
амайыԓгаым ванэван нырэӄынэт ӈэвысӄэтти ӄынвэр ӄоԓетъыԓё тэӈэтэкичгыкэ нъэԓгъэт таӈымыԓьо гагтоԓенат кэйӈэ	в а н э в а н _ н ы р э ӄ ы н э т _ # _ ӄ ы н в э р _ # _ т э ӈ э т э к и ч г ы к э _ # _ т а ӈ ы м ы ԓ ь о _ # _ # _
ӄуԓивуԓӄытвик энарэрыԓьатыӈӈогъат рэноԓгыгэӈгыпы ԓыгэн	э н а р э р ы ԓ ь а т ы ӈ ӈ о г ъ а т _ р э н о ԓ г ы г э ӈ г ы п ы _ ԓ ы г э н _
ӄун	
ныԓгивэгыткуԓьэтӄинэт	
уйӈэ нытваӄэнат	н ы т в а ӄ э н а т _
ԓюур	
ӄотԓяйӈын ёрогты	ё р о г т ы _
кытгъи ерочыкон нэнчимиръэвын нанӄыԓьын нэпиригъэн ынӄо таӈавынӄоԓеԓьыръогты	е р о ч ы к о н _ н э н ч и м и р ъ э в ы н _ н а н ӄ ы ԓ ь ы н _ н э п и р и г ъ э н _ # _ # _
нанынтоӈатын ӈаргыногты эргатръогъэ таӈамынан нъэԓгъи чимгъугъи ӈэвысӄэт тэйкынин тытԓык ваны варэсӄыткынык	ӈ а р г ы н о г т ы _ э р г а т р ъ о г ъ э _ # _ н ъ э ԓ г ъ и _ # _ # _ # _ # _ # _ # _
румэкэвъюунинэт уунъыкэнъут	у у н ъ ы к э н ъ у т _
ӈэнку натчытваӄэн	н а т ч ы т в а ӄ э н _
вуԓӄытвигъи нэмэ ԓыгэн ярачыкогты	н э м э _ ԓ ы г э н _ я р а ч ы к о г т ы _
авынгачагъат ытԓёным	ы т ԓ ё н ы м _
ӈоон гыргоԓ	г ы р г о ԓ _
нывакъотваӄэн нэмэ	н э м э _
моогъат энарэрыԓьатык	э н а р э р ы ԓ ь а т ы к _
инэԓьук ԓываквъат ӄоԓ	ԓ ы в а к в ъ а т _ ӄ о ԓ _
ӈытоӈӈой ӈытосӄэвыԓьын	ӈ ы т о с ӄ э в ы ԓ ь ы н _
ӈэвысӄэтэ ӈыԓенӈыԓетэ	ӈ ы ԓ е н ӈ ы ԓ е т э _
инэгнэрэннин ӄаптэткынык иргъи ӈыԓенӈыԓет ԓыгэным эвыр ынкэӄэй ӈыԓетръугъи кайӈиӈын авынгынтавыԓьатэты йытрыкымгытръогъэ	ӄ а п т э т к ы н ы к _ и р г ъ и _ # _ # _ э в ы р _ ы н к э ӄ э й _ ӈ ы ԓ е т р ъ у г ъ и _ # _ а в ы н г ы н т а в ы ԓ ь а т э т ы _ # _
ынӄоым гапэӄэттатԓен ӄотԓяйӈаым таӈгэмо нинэԓгыӄин	г а п э ӄ э т т а т ԓ е н _ # _ т а ӈ г э м о _ н и н э ԓ г ы ӄ и н _
тыԓвыԓьын ынин	ы н и н _
томгиӈын	
пԓыткугъи энарэрыԓьатык ӈытоӈӈой	э н а р э р ы ԓ ь а т ы к _ # _
кайӈиӈын нэмэ рэрэннин йынйынчыӈын	н э м э _ # _ # _
рыԓвэтъюунин ӈоонко	ӈ о о н к о _
пэӄэттатгъэ	
уйӈэ нъэԓгъи	н ъ э ԓ г ъ и _
эгытԓикэйӈыкэ ӄоԓетъыԓё пыкиргъи ӄааԓьатыԓьын	ӄ о ԓ е т ъ ы ԓ ё _ п ы к и р г ъ и _ # _
ӈэвъэнэ ԓыгэнитык	ԓ ы г э н и т ы к _
ԓыгъэйӈэчьивнин раӈӈытайым	р а ӈ ӈ ы т а й ы м _
эми ӄоԓ ӈэвысӄэт энмэч	ӄ о ԓ _ # _ э н м э ч _
ымыӈ гым вэнъыгну тыегтэԓык ԓыгэн аны	г ы м _ в э н ъ ы г н у _ # _ ԓ ы г э н _ а н ы _
гыт мурык	м у р ы к _
аӈъачгыргэгыт нымытвак	н ы м ы т в а к _
нэмэ нымытваӈӈогъат рымагтэты гытгаръогъэ яԓгытгъат рэвиквъэт	н ы м ы т в а ӈ ӈ о г ъ а т _ # _ г ы т г а р ъ о г ъ э _ # _ р э в и к в ъ э т _
йичьэннупык ӄача ынкы	ӄ а ч а _ ы н к ы _
ынраӄ кэтэм гатваԓен пэнинэԓьын ӄԓявыԓ чама ӄэгъюргын	к э т э м _ г а т в а ԓ е н _ # _ # _ ч а м а _ # _
тараӈыпԓыткогъат умуттуут пиринин ӄыԓявоԓя ынкъам	у м у т т у у т _ п и р и н и н _ ӄ ы ԓ я в о ԓ я _ # _
йъонэн	
въиԓьын ынкы ытръэч нытваӄэн пыгԓыԓявыт ынӄэн кыпԓынэн рычимиръэвнин ынӄо рагтыгъэ вуԓӄытвигъи	ы н к ы _ # _ н ы т в а ӄ э н _ # _ # _ к ы п ԓ ы н э н _ # _ # _ р а г т ы г ъ э _ в у ԓ ӄ ы т в и г ъ и _
ривыԓӄытгьи наӄамым ӈэԓвыԓ ярак камԓеԓы нытваӄэн ӈэвысӄэт амынан ярак пэԓятгъэ айвэчгыръогъэ ӈэвысӄэт ванэван ныйыԓӄэтын ԓюур	н а ӄ а м ы м _ ӈ э ԓ в ы ԓ _ # _ к а м ԓ е ԓ ы _ н ы т в а ӄ э н _ # _ # _ я р а к _ п э ԓ я т г ъ э _ а й в э ч г ы р ъ о г ъ э _ # _ в а н э в а н _ # _ # _
рай ръэнут выргыргэтгъи тытԓыӄачайпы ӈэвысӄэт паԓёмтэԓгъэ нэмэ рай выргыргыръугьи яраттатгъэ ӄытԓыги рыногыргэпы	р ъ э н у т _ в ы р г ы р г э т г ъ и _ # _ ӈ э в ы с ӄ э т _ п а ԓ ё м т э ԓ г ъ э _ # _ р а й _ в ы р г ы р г ы р ъ у г ь и _ # _ ӄ ы т ԓ ы г и _ р ы н о г ы р г э п ы _
ԓевыт ръыԓинин ынӄо нывэтгавӄэн микынэ гымнин ԓевыт гэнчимиръэвԓин иԓпыгитэ	р ъ ы ԓ и н и н _ ы н ӄ о _ н ы в э т г а в ӄ э н _ # _ г ы м н и н _ # _ г э н ч и м и р ъ э в ԓ и н _ # _
ръыԓинин увик ээ вынэ авъеткынка ӄытватык эрэтгъи рыногыргыткынгыпы	у в и к _ # _ # _ а в ъ е т к ы н к а _ # _ # _ р ы н о г ы р г ы т к ы н г ы п ы _
ынраӄ аграткынык иргъи эми авынраԓьын ээ	а г р а т к ы н ы к _ # _ э м и _ # _ # _
уйӈэээ ээ уйӈэээ чьовыргын	э э _ у й ӈ э э э _ # _
рывэнтэннин ӈэвысӄэт гэԓгичеӈыттэтԓин рыпэт гэтэӈуԓвэвԓин ыннэнпэнинэк пынԓёԓьатыӈӈогъэ каԓьайӈын микынэӈ гэнчимэвԓин ээ	ӈ э в ы с ӄ э т _ # _ # _ # _ # _ п ы н ԓ ё ԓ ь а т ы ӈ ӈ о г ъ э _ к а ԓ ь а й ӈ ы н _ м и к ы н э ӈ _ # _ э э _
вынэ ӄымӈыԓтэԓыркын ӈэвысӄэт	ӄ ы м ӈ ы ԓ т э ԓ ы р к ы н _ # _
моогъэ вэтгавык гымык ывэӄучитэ ынӈин рыннин миӈкыри ӄун ԓыгиӄэгъюргын	в э т г а в ы к _ г ы м ы к _ ы в э ӄ у ч и т э _ # _ # _ м и ӈ к ы р и _ ӄ у н _ ԓ ы г и ӄ э г ъ ю р г ы н _
гымнин ывэӄуч чама ԓыгъэткиӈ ԓыгэн	ы в э ӄ у ч _ ч а м а _ # _ # _
ӄун эӄэгкутъюунин каԓьайӈын	э ӄ э г к у т ъ ю у н и н _ # _
иквъи мурык рэтэӈычьэтгъэ ынӄэн	м у р ы к _ р э т э ӈ ы ч ь э т г ъ э _ # _
ӄырымэн кэԓы въиԓьын пэнинэԓьын	к э ԓ ы _ # _ # _
ынӄо рынтоӈаннэн эргатык	р ы н т о ӈ а н н э н _ # _
эвын эргыръоӈӈок ӄԓявыԓ рагтыгъэ амын	э р г ы р ъ о ӈ ӈ о к _ # _ р а г т ы г ъ э _ а м ы н _
эвын уйӈэ ярак ӈэвысӄэт	у й ӈ э _ я р а к _ ӈ э в ы с ӄ э т _
ӄырирнин танԓымынӄоԓьук	т а н ԓ ы м ы н ӄ о ԓ ь у к _
ԓывавнэн ынӄо маёԓгыткынэты ӄытгъи 	ы н ӄ о _ м а ё ԓ г ы т к ы н э т ы _ # _ _
эвын ӈэнку нарычгытваӄэн гитэнин эвын гэвъиԓин ԓюӈпиритэ ымыӈ рыннин	ӈ э н к у _ # _ # _ # _ г э в ъ и ԓ и н _ ԓ ю ӈ п и р и т э _ # _ р ы н н и н _
ԓыгэн рагтыгъэ кытгынта рырэйвэвнин яраӈы	р а г т ы г ъ э _ к ы т г ы н т а _ # _ я р а ӈ ы _
ԓыгэӄыԓпэ ынкъам яԓгытгъэ нымгутыԓеӄин гэԓгуврэмгутыԓеԓин рэвиквъи	ы н к ъ а м _ # _ # _ г э ԓ г у в р э м г у т ы ԓ е ԓ и н _ р э в и к в ъ и _
вытку воԓӄытвэма тараӈгъэ	в о ԓ ӄ ы т в э м а _ т а р а ӈ г ъ э _
ԓыгэӄыԓпэ ԓыгэн	ԓ ы г э н _
апԓёратвака рай	р а й _
ӄоԓейӈын	
мооръэтыӈӄачайпы	
вэгрэтээм эмитԓёнайгоот коԓё наӄам	э м и т ԓ ё н а й г о о т _ к о ԓ ё _ н а ӄ а м _
отконаӈайӈыт нынрыӄинэт пыкэрычгатгъат кынмаԓ ԓыгэн ынкы нанмын вэгрэтэм ынаным иам ныпичгыӄин с энмэн ӄоԓ	н ы н р ы ӄ и н э т _ п ы к э р ы ч г а т г ъ а т _ к ы н м а ԓ _ ԓ ы г э н _ # _ н а н м ы н _ # _ # _ и а м _ # _ # _ э н м э н _ ӄ о ԓ _
имъэԓиԓьин ӄԓявыԓ амыным нивӄин нивӄинэт энмэн	ӄ ԓ я в ы ԓ _ а м ы н ы м _ н и в ӄ и н _ # _ # _
ынӄэн имъэԓиԓьырык гатваԓен тэԓенъеп	и м ъ э ԓ и ԓ ь ы р ы к _ # _ т э ԓ е н ъ е п _
энмэн ӄоԓ имъэԓиԓьин ӄԓявыԓ	ӄ о ԓ _ и м ъ э ԓ и ԓ ь и н _ # _
амыным нивӄин выквыԓгын ӈутку ниниԓгэтӄин ӈиԓгэ ынкъам	н и в ӄ и н _ # _ # _ # _ # _ ынкъам _
ныриӈэӄин ыяа гыргоԓягты риӈэгъи ӄоԓетъыԓё коԓё ёо гэпкитԓин айгынԓейпы наӄам ынкэкин ымыԓьо гивиниԓинэт 	ы я а _ г ы р г о ԓ я г т ы _ # _ ӄ о ԓ е т ъ ы ԓ ё _ # _ # _ г э п к и т ԓ и н _ # _ # _ ы н к э к и н _ # _ # _ # _
гэнԓьэтэтԓинэт гэԓыткынык	г э ԓ ы т к ы н ы к _
ымыԓьо имъэԓиԓьыт ӄԓявыԓтэ ынӄо	и м ъ э ԓ и ԓ ь ы т _ # _ ы н ӄ о _
ӈырача кивкы ӄԓявыԓен нэнэны гивԓин эптэ	к и в к ы _ ӄ ԓ я в ы ԓ е н _ н э н э н ы _ # _ # _
гым ытԓыгмиԓ мыриӈэгъэк ытԓьата нинивӄин ынӄо гэвэнэчаԓен имъэԓиԓьын ӈинӄэй ынӄэн тъэче киквъи ёатык	ы т ԓ ы г м и ԓ _ # _ ы т ԓ ь а т а _ н и н и в ӄ и н _ ы н ӄ о _ # _ # _ ӈ и н ӄ э й _ ы н ӄ э н _ # _ # _ ё а т ы к _
ярак ынӄоры ынӄэн ӈинӄэй	ы н ӄ о р ы _ # _ # _
иквъи амын амморгынан мытынъэԓмык мэӈӄо мури	а м ы н _ а м м о р г ы н а н _ # _ м э ӈ ӄ о _ м у р и _
мытраӄамэтва ԓымӈэ иквъи ытԓьата ивнин ӈинӄэй	ԓ ы м ӈ э _ и к в ъ и _ ы т ԓ ь а т а _ # _ ӈ и н ӄ э й _
гивԓин ытԓьата ивнин эккэтэ ивнин	ы т ԓ ь а т а _ # _ э к к э т э _ # _
кита имъэԓиԓьын мыёпатынат аӈӄата рыԓьататъёттэ ытԓьата ивнин	и м ъ э ԓ и ԓ ь ы н _ # _ а ӈ ӄ а т а _ р ы ԓ ь а т а т ъ ё т т э _ # _ и в н и н _
ӈинӄэе ивнин наӄам ёо коԓё ӄынвэр ытԓьата ивнин ӈинӄэй	и в н и н _ н а ӄ а м _ ё о _ к о ԓ ё _ # _ # _ # _ ӈ и н ӄ э й _
иквъи эвыр трэԓьуӈын эӄыԓпэ трэетгъэ ымыԓьо	э в ы р _ т р э ԓ ь у ӈ ы н _ э ӄ ы ԓ п э _ т р э е т г ъ э _ # _
имъэԓиԓьыт гумэкэтԓинэт нивӄинэт эквэтгъи коԓё ёо авынтыԓягты	г у м э к э т ԓ и н э т _ н и в ӄ и н э т _ # _ # _ # _ а в ы н т ы ԓ я г т ы _
ӄытгъи ӄоԓ	ӄ о ԓ _
ԓьунин ӄԓявыԓ нэмыӄэй	ӄ ԓ я в ы ԓ _ # _
риӈэԓьын ивнин ԓюур иквъи гытым нырэӄигыт имъэԓиԓьэ	и в н и н _ ԓ ю у р _ и к в ъ и _ г ы т ы м _ # _ # _
ивнин уӈииԓьэ ивнин	у ӈ и и ԓ ь э _ # _
имъэԓиԓьэ ивнин уӈииԓьэ	и в н и н _ у ӈ и и ԓ ь э _
ивнин ынӄоры ынӈин	ы н ӄ о р ы _ # _
вэтгавма ԓюур уӈииԓьэ кыпԓынэн аԓыгатгата имъэԓиԓьын	ԓ ю у р _ у ӈ и и ԓ ь э _ # _ а ԓ ы г а т г а т а _ # _
ԓевыт гэчвиԓин имъэԓиԓьын эрэтгьи гэԓыткынык иргъи уйӈэ эриӈэкэ нъэԓгъи	г э ч в и ԓ и н _ # _ # _ г э ԓ ы т к ы н ы к _ и р г ъ и _ # _ # _ # _
ынӄоры уӈииԓьэ аԓыгаттэ тиӈунин эйминнин ынӄо нымэԓьэв	у ӈ и и ԓ ь э _ # _ т и ӈ у н и н _ э й м и н н и н _ # _ н ы м э ԓ ь э в _
нъыркыпԓынэн	
имъэԓиԓьын риӈэгъи выква иннин уӈииԓьын 	р и ӈ э г ъ и _ в ы к в а _ # _ # _ _
рымутԓытъэвнин	
уӈииԓьын	
эрэтгъи гэԓыткынык итгъи мъэԓиԓьэ выквыԓгын тиӈунин	г э ԓ ы т к ы н ы к _ # _ # _ # _ т и ӈ у н и н _
иӈӄун нъынчимэвнин ԓевыт	н ъ ы н ч и м э в н и н _ # _
иӈӄун нъывъигъэн	н ъ ы в ъ и г ъ э н _
эчги тиӈунин имъэԓиԓьэ аԓыгаттэ	т и ӈ у н и н _ # _ # _
ԓюур рыркайӈын пиврэгъи эчги	р ы р к а й ӈ ы н _ # _ # _
ынӈот рыннин эчги тымыркынэнрыркайӈа	р ы н н и н _ # _ # _
ранӈавнэн уӈииԓьын уйӈэ ръэнут	у ӈ и и ԓ ь ы н _ у й ӈ э _ р ъ э н у т _
гэԓьуԓин ганӈатԓен ынӄоры имъэԓиԓьын рагтыгъэ пыкирык	г а н ӈ а т ԓ е н _ ы н ӄ о р ы _ и м ъ э ԓ и ԓ ь ы н _ # _ п ы к и р ы к _
эвын гэмутԓыԓин никвъэн тумгэ ынӄэйына	г э м у т ԓ ы ԓ и н _ # _ т у м г э _ # _
гэнъаԓыгатгапԓен чит энмэн уӈииԓьыт гэнԓьэтэтъюуԓинэт	ч и т _ э н м э н _ # _ # _
нэмыӄэй энарэрыԓьа гинэԓьуԓин	э н а р э р ы ԓ ь а _ # _
гэнъаԓыгатгапԓен паагъэ риӈэк эԓеръугъи панэна эмэԓевкыԓьин	п а а г ъ э _ р и ӈ э к _ # _ п а н э н а _ # _
ԓевыт иквъи эптэ гым мычавчывантагъак	и к в ъ и _ # _ # _ м ы ч а в ч ы в а н т а г ъ а к _
ԓьораӄоймагты имъэԓиԓьыт ӄытгъэт пыкиргъэт ԓьораӄоймак эвын	и м ъ э ԓ и ԓ ь ы т _ ӄ ы т г ъ э т _ п ы к и р г ъ э т _ ԓ ь о р а ӄ о й м а к _ # _
уӈииԓьыт ынкы нэмыӄэй	ы н к ы _ н э м ы ӄ э й _
атынвыԓьын ынкы ӄытԓыги ынин	ы н к ы _ ӄ ы т ԓ ы г и _ # _
атынватъё ымыӈ гачавчывантаԓен	ы м ы ӈ _ г а ч а в ч ы в а н т а ԓ е н _
ӈирэче кивкы ӄытгъи	к и в к ы _ ӄ ы т г ъ и _
уӈииԓьын ивнин имъэԓиԓьэ ивнин	и в н и н _ и м ъ э ԓ и ԓ ь э _ # _
гым эквырга тымэйӈэтык ынӈин ваԓьэгым уӈииԓьэ нинивӄин	э к в ы р г а _ # _ # _ в а ԓ ь э г ы м _ # _ # _
ӄэйвэ мэԓгыт тыԓьугыт	м э ԓ г ы т _ # _
ԓьэԓеӈкы риӈэк имъэԓиԓьэ	р и ӈ э к _ # _
нинивӄин эты эԓвэԓьин	э т ы _ # _
уӈииԓьэ тумгыт нинивӄинэт	т у м г ы т _ н и н и в ӄ и н э т _
тумгэ нивӄин ӄэгԓынангэт	н и в ӄ и н _ # _
ԓёӈынма рагтыгъат имъэԓиԓьыт пыкиргъэт румэкэвнин	р а г т ы г ъ а т _ # _ # _ р у м э к э в н и н _
имъэԓиԓьыт ымыԓьо ивнинэт ӄоԓ имъэԓиԓьын иквъи экык иквъи ытԓьата	ы м ы ԓ ь о _ и в н и н э т _ # _ # _ # _ э к ы к _ # _ ы т ԓ ь а т а _
ивнин вэчьым гыт ымыӈ рэӄысӄычевыӈ ӄырым ӄыетги	в э ч ь ы м _ г ы т _ # _ # _ # _ ӄ ы е т г и _
ӄынвэр ынӄэн эккэӄэй никвъэн имъэԓиԓьэ нэмэ экык риӈэгъи нэмэ выквыԓгын	ы н ӄ э н _ э к к э ӄ э й _ # _ и м ъ э ԓ и ԓ ь э _ # _ э к ы к _ # _ # _ в ы к в ы ԓ г ы н _
пэнин патгыргыԓгын ԓьунин гыргоԓ ԓыгэн ынкэгйит гатааԓен	п а т г ы р г ы ԓ г ы н _ # _ г ы р г о ԓ _ # _ # _ г а т а а ԓ е н _
пинтыӄэтгъи гыргоԓ эвын	г ы р г о ԓ _ # _
ынкы ԓьунин ӈагчыӈын никвыӄин	ԓ ь у н и н _ ӈ а г ч ы ӈ ы н _ # _
ынкэгйит ныԓеӄин иквъи миӈкэтэ гыргоча мытаан юур никвъэн	н ы ԓ е ӄ и н _ # _ # _ # _ # _ # _ н и к в ъ э н _
ыныкит ынкы рэймэвнин	ы н к ы _ р э й м э в н и н _
эвын ытԓыгын ынин ынкы варкын кымъыйӈа	ы т ԓ ы г ы н _ ы н и н _ # _ # _ к ы м ъ ы й ӈ а _
гэпириԓин мынга гытката эккэтэ ԓьунин ытԓыгын	м ы н г а _ # _ э к к э т э _ ԓ ь у н и н _ # _
гаԓягъэ ивнин ивнин эккэтэ ивнин тыԓӄыриргыт ытԓыгэ ивнин ӈотӄэн	и в н и н _ и в н и н _ # _ # _ т ы ԓ ӄ ы р и р г ы т _ # _ и в н и н _ ӈ о т ӄ э н _
кымъыԓгын нымэйыӈӄин коԓё гыткат	н ы м э й ы ӈ ӄ и н _ к о ԓ ё _ # _
нымкыӄинэт нивԓыӄинэт	н и в ԓ ы ӄ и н э т _
вайым гым ымыԓьо вагыԓгын гинэпԓин чамъам трэриӈэгъэ ӄонпыӈ гым ӈутку тынъэԓык эккэтэ ивнин тиӈунин	г ы м _ ы м ы ԓ ь о _ # _ # _ ч а м ъ а м _ т р э р и ӈ э г ъ э _ # _ г ы м _ # _ # _ # _ и в н и н _ т и ӈ у н и н _
выквыԓгын выквыԓгын ринтынин	в ы к в ы ԓ г ы н _ # _
кымъыԓгын кымъукэтгъи ытԓыгын пынԓёнэн	к ы м ъ у к э т г ъ и _ ы т ԓ ы г ы н _ п ы н ԓ ё н э н _
ивнин ытԓыгэ	ы т ԓ ы г э _
нэмэ	
тиӈунин нэмэ ринтынин нэмэ	н э м э _ # _ # _
кымъукэтгъи гынмыԓкинэк майыӈкы	г ы н м ы ԓ к и н э к _ м а й ы ӈ к ы _
ытԓыгын пынԓёнэн нэмэ	п ы н ԓ ё н э н _ н э м э _
тиӈунин ӈыроӄавкы ринтынин кымъыԓгын	ӈ ы р о ӄ а в к ы _ # _ к ы м ъ ы ԓ г ы н _
ымыԓьэты	
ӄынур тымнэн гыткат	т ы м н э н _ # _
янра ымыӈ ынин	ы м ы ӈ _ # _
ытԓыгын тымнэн	т ы м н э н _
ынӄо груԓмыгъи	г р у ԓ м ы г ъ и _
ытԓыгин инничгын ԓьунин	и н н и ч г ы н _ ԓ ь у н и н _
ынӄэн эйминнин иквъи	э й м и н н и н _ # _
вэԓерым ытԓыгын тыԓьугъэн ӈотӄэн	ы т ԓ ы г ы н _ # _ # _
эмэԓкэ ытԓыгын тынрагтатын ӈэвъэнэ рэԓьугнин ӄэгԓынангэт агтыгъэ пыкирык ивнин ԓюур ынӄэн ытԓьата	ы т ԓ ы г ы н _ # _ # _ р э ԓ ь у г н и н _ # _ # _ # _ и в н и н _ ԓ ю у р _ ы н ӄ э н _ ы т ԓ ь а т а _
ивнин мэӈӄо ԓьугьэн эккэтэ	м э ӈ ӄ о _ ԓ ь у г ь э н _ # _
ивнин наӄам ымыԓьо гыткаԓгыт нымкыӄин эвын аӄаятыӈ гымнин ытԓыгын кымъэ гэпириԓин ытԓьата ивнин эккэтэ ивнин	н а ӄ а м _ ы м ы ԓ ь о _ г ы т к а ԓ г ы т _ # _ э в ы н _ # _ # _ ы т ԓ ы г ы н _ к ы м ъ э _ # _ # _ # _ э к к э т э _ # _
эмимъэԓик тынъэԓык ӄырым ԓым ыяагты мыԓӄытык	т ы н ъ э ԓ ы к _ ӄ ы р ы м _ ԓ ы м _ ы я а г т ы _ # _
вэԓерым ытԓыгын тыԓьугъэн ӄонпыӈ	ы т ԓ ы г ы н _ # _ # _
игыр тыпаак ытръэч эвэнэԓьэты игыр трэвинрээркын игыр ӄонпыӈ	т ы п а а к _ ы т р ъ э ч _ э в э н э ԓ ь э т ы _ # _ т р э в и н р э э р к ы н _ # _ ӄ о н п ы ӈ _
ыяагты риӈэк тыпаак с	р и ӈ э к _ # _ с _
амыным аны ныԓгэӈъоӄэн ымы ваԓы чаат	а н ы _ н ы ԓ г э ӈ ъ о ӄ э н _ # _ в а ԓ ы _ # _
кукэт пойгыт уйӈэ наӄам	п о й г ы т _ у й ӈ э _ н а ӄ а м _
ӈэԓвыԓ нымкыӄин	н ы м к ы ӄ и н _
энмэн нанӄытэмтэӈ ганымытваԓен	н а н ӄ ы т э м т э ӈ _ # _
ытръэч тэӈэмӈэԓвыԓекы уйӈэ	т э ӈ э м ӈ э ԓ в ы ԓ е к ы _ # _
аракыԓьэн ымы ԓыгэн	ы м ы _ ԓ ы г э н _
ӄун ӈэвъэн уйӈэ таӈамынан	ӈ э в ъ э н _ # _ # _
ганымытваԓен ӈэԓвыԓекы амыным	ӈ э ԓ в ы ԓ е к ы _ # _
аны ныԓгэӈъоӄэн ымы	н ы ԓ г э ӈ ъ о ӄ э н _ # _
ваԓы чаат кукэт	ч а а т _ # _
пойгыт уйӈэ наӄам ӈэԓвыԓ нымкыӄин	у й ӈ э _ н а ӄ а м _ ӈ э ԓ в ы ԓ _ н ы м к ы ӄ и н _
энмэн нанӄытэмтэӈ ынӄэн	н а н ӄ ы т э м т э ӈ _ # _
нынны ынин аны ныԓгэӄамэтваӄэн	ы н и н _ а н ы _ # _
ыныкит гытъэвкы ӄоԓ	г ы т ъ э в к ы _ # _
итгъи вуԓӄытвик ӄаанматгъэ ԓыгэн	в у ԓ ӄ ы т в и к _ # _ # _
кытгынтыпэрэта рыннин ӄораӈы наӄам	р ы н н и н _ ӄ о р а ӈ ы _ # _
аны ныԓгининъыӄин нанӄытэмтэӈ чама	н ы ԓ г и н и н ъ ы ӄ и н _ # _ ч а м а _
ныԓгэнымԓыӄэн ынӄэн ынкы	ы н ӄ э н _ # _
кытгынтыпэрэнэн ӄораӈы ынӄо риԓгыпэтэ	ӄ о р а ӈ ы _ ы н ӄ о _ # _
рыннин ынраӄ эрынвэ рыннинэт гыткат ԓыгэн мыԓенинэт гыткат мынга ынӄо тэтивэԓе инэвэнӈэтгъи	ы н р а ӄ _ # _ # _ г ы т к а т _ # _ # _ # _ м ы н г а _ # _ т э т и в э ԓ е _ # _
ынӄо ӄорэн нанӄын тэйкынин	ӄ о р э н _ # _ # _
ынкъам мэмԓытыёнэн ынӄо рыратыквыткынык рытриԓнин ынӈин нувиӄин нанӄытэмтэӈ	м э м ԓ ы т ы ё н э н _ # _ р ы р а т ы к в ы т к ы н ы к _ # _ ы н ӈ и н _ # _ # _
ӄорананӄыткынык вычгывыквыткынык таӈымыԓьэты ыпаннэн аймак	в ы ч г ы в ы к в ы т к ы н ы к _ т а ӈ ы м ы ԓ ь э т ы _ ы п а н н э н _ а й м а к _
ынӄо гатарыгъёԓгынԓен нанӄыванвыԓӄыԓ гэтэйкыԓин	г а т а р ы г ъ ё ԓ г ы н ԓ е н _ # _ г э т э й к ы ԓ и н _
амыным ӄамэтваӈӈогъэ	ӄ а м э т в а ӈ ӈ о г ъ э _
апаӄатԓыткогъэ аны гаӄамэтваԓен таӈымыԓьэты	а н ы _ г а ӄ а м э т в а ԓ е н _ т а ӈ ы м ы ԓ ь э т ы _
кунин ӄаанмэ	ӄ а а н м э _
ынӄо ӄутгъи	ӄ у т г ъ и _
нанӄыйӈын гэԓгимэйӈэтԓин гагэнрычгатԓен ынӄо ӈиԓгэ тимтигнин нанӄын	г э ԓ г и м э й ӈ э т ԓ и н _ г а г э н р ы ч г а т ԓ е н _ ы н ӄ о _ ӈ и ԓ г э _ # _ # _
ӈэԓвыԓ вэгтиԓгъи наӄам ыныкит ныгытъэвӄин	в э г т и ԓ г ъ и _ # _ ы н ы к и т _ н ы г ы т ъ э в ӄ и н _
ныԓгимӄытвиӄин нанӄын наӄам ыныкит ныпԓыӄамэтваӄэн	н а н ӄ ы н _ н а ӄ а м _ # _ н ы п ԓ ы ӄ а м э т в а ӄ э н _
ныԓгэгэнрычгатӄэн нанӄын рыпэт	н а н ӄ ы н _ р ы п э т _
ӄун кыԓтэ	к ы ԓ т э _
нинэтчыӄин нанӄын ынӄэн	н а н ӄ ы н _ ы н ӄ э н _
тэӈэмынӈин ганымытваԓен тумгэӄэй нанӄытэмтэӈ амын ӄоԓ итгъи вуԓӄытвик нэмэ ӄаанматгъэ ынраӄ нымэчыӄэргыԓьатӄэн	г а н ы м ы т в а ԓ е н _ т у м г э ӄ э й _ # _ # _ ӄ о ԓ _ и т г ъ и _ в у ԓ ӄ ы т в и к _ # _ # _ ы н р а ӄ _ н ы м э ч ы ӄ э р г ы ԓ ь а т ӄ э н _
увэма ӈэԓвыԓым нытԓытваӄэн ԓюур вай рымъэйӈэткун авач авач ԓыгэн эвыр	ӈ э ԓ в ы ԓ ы м _ н ы т ԓ ы т в а ӄ э н _ # _ в а й _ р ы м ъ э й ӈ э т к у н _ # _ а в а ч _ ԓ ы г э н _ # _
гагчыръогъэ нанӄытэмтэӈ эӄыԓпэ эръыкыргыт ӈирэӄ энатыёйвынэнат уунъыкэнъутэ ынкъам рытрэтэ	н а н ӄ ы т э м т э ӈ _ э ӄ ы ԓ п э _ э р ъ ы к ы р г ы т _ # _ э н а т ы ё й в ы н э н а т _ # _ ынкъам _ р ы т р э т э _
ԓьуԓӄыԓеннинэт ынӄоым мачыяа рывакъовнэнат ӈирэк рытрэԓьуԓӄытԓьэт	ы н ӄ о ы м _ м а ч ы я а _ # _ # _ р ы т р э ԓ ь у ԓ ӄ ы т ԓ ь э т _
эръыкыргыт аны ӈоты	а н ы _ ӈ о т ы _
энмэч гапкэрыӈӈоԓен ӄытԓыги эӄэԓьымкын ӈэԓвыԓым ынкы	г а п к э р ы ӈ ӈ о ԓ е н _ # _ э ӄ э ԓ ь ы м к ы н _ # _ ы н к ы _
нытԓытваӄэн панэна ынӄо атчысӄэквъэ нанӄытэмтэӈ	п а н э н а _ ы н ӄ о _ # _ # _
омкычыкогты аны вай ныԓӄэгнэвъюуӄинэт	а н ы _ в а й _ н ы ԓ ӄ э г н э в ъ ю у ӄ и н э т _
мачыяа вакъотваԓьыт	в а к ъ о т в а ԓ ь ы т _
эръыкыргыт тиӈурэ нынпыткэвъюуӄинэт	т и ӈ у р э _ н ы н п ы т к э в ъ ю у ӄ и н э т _
тиӈурмъэмитэ вачаӄ	в а ч а ӄ _
ванэван ынынпэӄэттавынат эръыкыргыт	ы н ы н п э ӄ э т т а в ы н а т _ # _
миӈкыри ӄун нивӄинэт ытри энмэн ынӄэнат	ӄун _ н и в ӄ и н э т _ # _ # _ # _
ӈирэӄ оравэтԓьат натаӈыԓвавынат тымык	о р а в э т ԓ ь а т _ н а т а ӈ ы ԓ в а в ы н а т _ # _
ӄынвэр найъонат ӈирэӄ эръыкыргыт ӄытԓыги ынӄэнат эръыкыргыт ытръэч уунъыкэнъутэ гэнатыёԓенат выԓ нымкыӄин наӄам уйӈэ этынвыка	н а й ъ о н а т _ # _ э р ъ ы к ы р г ы т _ # _ ы н ӄ э н а т _ э р ъ ы к ы р г ы т _ # _ у у н ъ ы к э н ъ у т э _ # _ в ы ԓ _ н ы м к ы ӄ и н _ н а ӄ а м _ # _ э т ы н в ы к а _
опопы моргынан	м о р г ы н а н _
ӈэԓвыԓ мыныԓгын миӈкыри ӄун эми авынраԓьыт энмэч эргатык	м ы н ы ԓ г ы н _ # _ ӄ у н _ э м и _ # _ # _ # _
мынагтатын ӈэԓвыԓ тумгытым ночыткоӄэнат	ӈ э ԓ в ы ԓ _ т у м г ы т ы м _ # _
нанвэтгавын ӈэԓвыԓ эргатык агтатынвы амыным энмэч тэӈунтымэквъэт ынкы ӄамэтваԓьатгъат ынкы эчги ӄэмипԓыткугъэт ынкы	ӈ э ԓ в ы ԓ _ э р г а т ы к _ а г т а т ы н в ы _ # _ э н м э ч _ # _ # _ ӄ а м э т в а ԓ ь а т г ъ а т _ # _ э ч г и _ ӄ э м и п ԓ ы т к у г ъ э т _ # _
ԓыгэн йыԓӄатчагъат наӄам таӈымыԓьо ирвыгинив ыннэнԓеӈкы натанмайӈэвынат ынӄоым йыԓӄатчагъат амыным нанӄытэмтэӈына чамэттанэнат	й ы ԓ ӄ а т ч а г ъ а т _ # _ т а ӈ ы м ы ԓ ь о _ # _ # _ н а т а н м а й ӈ э в ы н а т _ ы н ӄ о ы м _ й ы ԓ ӄ а т ч а г ъ а т _ # _ н а н ӄ ы т э м т э ӈ ы н а _ # _
йыԓӄыԓьыт йъонэнат эвын	йъонэнат _ э в ы н _
таӈвытрыӈ ныйыԓӄатчаӄэнат аӄаԓымкиӈыт ынӄо танмайӈытваԓьыт ирвыгинив майынԓяйвынэнат нотагты омкычыкогты ынӄо йъонэнат	н ы й ы ԓ ӄ а т ч а ӄ э н а т _ # _ ы н ӄ о _ т а н м а й ӈ ы т в а ԓ ь ы т _ # _ м а й ы н ԓ я й в ы н э н а т _ н о т а г т ы _ о м к ы ч ы к о г т ы _ # _ й ъ о н э н а т _
йыԓӄыԓьыт ытръэч ыннэн пойгын рынрынин	ы т р ъ э ч _ ы н н э н _ п о й г ы н _ # _
эвын ныӄынӈырвэԓыръоӄэнат эӄэԓьыгинив	н ы ӄ ы н ӈ ы р в э ԓ ы р ъ о ӄ э н а т _ # _
аны рымъэйӈэнинэт эӄэԓьыгинив	р ы м ъ э й ӈ э н и н э т _ # _
ынӄо йъонэнат йыԓӄыԓьыт ытръэч ыннэн пойгын	й ъ о н э н а т _ # _ # _ ы н н э н _ п о й г ы н _
рынрынин эвын ныӄынӈырвэԓыръоӄэнат эӄэԓьыгинив аны рымъэйӈэнинэт эӄэԓьыгинив аны гараԓеԓӄотчаԓенат	э в ы н _ # _ # _ а н ы _ # _ # _ а н ы _ # _
аӄаԓьымкычгын ԓыгэн ԓыԓенвэнтинэӈу ныпойгырэтръоӄэнат уйӈэ	ԓ ы г э н _ ԓ ы ԓ е н в э н т и н э ӈ у _ # _ у й ӈ э _
ԓьук ныԓвавӄэнат аны ынкы кэмчичевръуԓьыт	н ы ԓ в а в ӄ э н а т _ # _ ы н к ы _ к э м ч и ч е в р ъ у ԓ ь ы т _
ԓыгэн нэнанмыткойвыӄэнат пойга нанӄытэмтэӈына	н э н а н м ы т к о й в ы ӄ э н а т _ # _ н а н ӄ ы т э м т э ӈ ы н а _
ынкы тымыткойвынэнат таӈымыԓьо	т ы м ы т к о й в ы н э н а т _ # _
ынӄо	
тумгэӄэй нанӄытэмтэӈ ирвынӈэгъи игырым эӄэԓьэ нарынноркын	н а н ӄ ы т э м т э ӈ _ # _ и г ы р ы м _ э ӄ э ԓ ь э _ н а р ы н н о р к ы н _
вуԓӄытвигъи	
ԓюур ӈайъэннысӄэпы ининигъи	ӈ а й ъ э н н ы с ӄ э п ы _ # _
этратчыӈын эвын гаӄоԓема ныԓгирымъэйӈэткуӄинэт	э в ы н _ г а ӄ о ԓ е м а _ # _
нанӄытэмтэӈ нанӄытэмтэӈым нытаӈонтымытваӄэн таӈванэван найыԓгавын энмэч нытэнмавыткоӄэн ԓюур	н а н ӄ ы т э м т э ӈ ы м _ н ы т а ӈ о н т ы м ы т в а ӄ э н _ т а ӈ в а н э в а н _ н а й ы ԓ г а в ы н _ # _ н ы т э н м а в ы т к о ӄ э н _ # _
пыкэтчагъат аӄаԓымкиӈын накамԓеԓтагъан нанӄытэмтэӈ аны	а ӄ а ԓ ы м к и ӈ ы н _ н а к а м ԓ е ԓ т а г ъ а н _ н а н ӄ ы т э м т э ӈ _ а н ы _
нанӄытэмтэӈына пойгычгын гэниԓюԓин	п о й г ы ч г ы н _ г э н и ԓ ю ԓ и н _
ԓюур гыргоԓятгъэ таӈампойгыԓьата	г ы р г о ԓ я т г ъ э _ # _
нанӄытэмтэӈ ооԓёкоԓё аны ныԓгинымкыӄин аӄаԓьэтратчыӈын ԓюур выентэтгъи	о о ԓ ё к о ԓ ё _ а н ы _ н ы ԓ г и н ы м к ы ӄ и н _ # _ # _ в ы е н т э т г ъ и _
камԓеԓтаё нанӄытэмтэӈ аны ынкы	н а н ӄ ы т э м т э ӈ _ а н ы _ ы н к ы _
моогъат маравкы наӄам пойгыԓьата мараквъат амыным нэмэ	м а р а в к ы _ н а ӄ а м _ п о й г ы ԓ ь а т а _ # _ а м ы н ы м _ # _
нанӄытэмтэӈына тэӈыткунин	т э ӈ ы т к у н и н _
эӄэԓьырэт этки гэрмэвԓин нанӄытэмтэӈ чама	э т к и _ г э р м э в ԓ и н _ # _ ч а м а _
гамчытвэԓен нэмэ рымагтэты нымытваӈӈогъэ	н э м э _ р ы м а г т э т ы _ # _
итыкым ныйъойвыӄэн эӄэԓьэ вачаӄым тымык натаӈыԓвавын ӄоԓ	н ы й ъ о й в ы ӄ э н _ # _ в а ч а ӄ ы м _ т ы м ы к _ # _ # _
итгъи ӈайыткынэты ёпыԓӄэквъэ нанӄытэмтэӈ	ӈ а й ы т к ы н э т ы _ # _ н а н ӄ ы т э м т э ӈ _
ԓюур ԓьунин ынкы	ԓ ь у н и н _ ы н к ы _
ӈэвысӄэт ӈэйык ивтыԓ нэнамӈыԓёӄэн нанӄытэмтэӈына ӈэвысӄэт эмъим	ӈ э й ы к _ # _ # _ # _ ӈ э в ы с ӄ э т _ э м ъ и м _
гынин ытԓьатэвытԓымым йичьэмиттумгыт кытвыԓӄуным рэӄэ нытэйӈэтигыт ынкъам ынӈин нытэйӈэтигым ынӄо	ы т ԓ ь а т э в ы т ԓ ы м ы м _ # _ к ы т в ы ԓ ӄ у н ы м _ # _ н ы т э й ӈ э т и г ы т _ # _ ы н ӈ и н _ н ы т э й ӈ э т и г ы м _ # _
ԓыгиейвэчеквъи нанӄытэмтэӈ ивнин эвыр гынин нэмыӄэй уйӈэ	н а н ӄ ы т э м т э ӈ _ и в н и н _ э в ы р _ г ы н и н _ # _ # _
опопы кынмаԓ мыннымытва	к ы н м а ԓ _ м ы н н ы м ы т в а _
ԓыгэным ӈэвысӄэт ԓыгэкоргаквъэ	ӈ э в ы с ӄ э т _ # _
ынӄо эквэтгъэт ӈаԓвыԓьэты	э к в э т г ъ э т _ ӈ а ԓ в ы ԓ ь э т ы _
аны ганымытваԓенат ынкы	г а н ы м ы т в а ԓ е н а т _ # _
энмэчым гаранӈаԓенат ытри энмэчым	г а р а н ӈ а ԓ е н а т _ # _ э н м э ч ы м _
аккантогъэ ӈэвъэн йытонэн ӈинӄэй	ӈ э в ъ э н _ й ы т о н э н _ # _
умиԓгуну нынны гитԓин ынӄо эчги	н ы н н ы _ г и т ԓ и н _ # _ э ч г и _
ӈэръамытԓыӈгэвэԓьо нъэԓгъи умиԓгу нэмэ ӄоԓ ӈинӄэй урэтгъи	н ъ э ԓ г ъ и _ у м и ԓ г у _ # _ ӄ о ԓ _ ӈ и н ӄ э й _ у р э т г ъ и _
ынӄэнат ӈинӄэгти мэйӈэтгъэт энмэч	ӈ и н ӄ э г т и _ # _ # _
мачамнотайпы ныԓейвыӄинэт гэтԓенъютэ ԓыгэным	н ы ԓ е й в ы ӄ и н э т _ г э т ԓ е н ъ ю т э _ # _
ԓыгэыяагты ныԓӄытыԓьэтӄинэт нанӄытэмтэӈын эккэт	н ы ԓ ӄ ы т ы ԓ ь э т ӄ и н э т _ н а н ӄ ы т э м т э ӈ ы н _ э к к э т _
наӄам ытԓыгын пэнин ӄораӄ	ы т ԓ ы г ы н _ # _ # _
ваԓьын нмэч умиԓгу мачьаачеко гэнъэтԓин ытԓеӈиым энмэч майӈыӈэнӄагчыӈын умиԓгун ытԓенъюн нынны	н м э ч _ # _ м а ч ь а а ч е к о _ г э н ъ э т ԓ и н _ ы т ԓ е ӈ и ы м _ # _ м а й ӈ ы ӈ э н ӄ а г ч ы ӈ ы н _ # _ ы т ԓ е н ъ ю н _ н ы н н ы _
тутъыԓӄут аны ӄытԓыги	а н ы _ ӄ ы т ԓ ы г и _
ытри нырэрмэвӈыӄинэт ынӄо	н ы р э р м э в ӈ ы ӄ и н э т _ # _
эчги тутъыԓӄут мэйӈэтгъи аатчеко нъэԓгъи ивнин	т у т ъ ы ԓ ӄ у т _ # _ а а т ч е к о _ # _ и в н и н _
умиԓгунэ	
ынӄо амъянра нъэԓгъэт аны котчой нутэк нытваӄэнат тэӈэмкытэ	а м ъ я н р а _ н ъ э ԓ г ъ э т _ # _ # _ # _ н ы т в а ӄ э н а т _ # _
ярагты ныԓӄытӄинэт ԓюур ӄуԓиникэк тутъыԓӄутынэ ивнин ынээԓьын нутэк	н ы ԓ ӄ ы т ӄ и н э т _ # _ # _ # _ # _ ы н э э ԓ ь ы н _ н у т э к _
миӈкыри ӄун умиԓгу вэнъым гаԓгэмчытвэԓен ынкъам умиԓгунэ нинивӄин	ӄун _ у м и ԓ г у _ # _ г а ԓ г э м ч ы т в э ԓ е н _ # _ у м и ԓ г у н э _ # _
ытԓеӈи тутъыԓӄутынэ вэнԓыги нинивъюуӄин ынээԓьын	т у т ъ ы ԓ ӄ у т ы н э _ # _ н и н и в ъ ю у ӄ и н _ # _
еп ныппыԓюйгыт энмэч этъоонмыԓ эвыр мэчынкы	н ы п п ы ԓ ю й г ы т _ # _ э т ъ о о н м ы ԓ _ # _ м э ч ы н к ы _
рэнъэԓгъэ мачынан ынӈин ӄытваркын	м а ч ы н а н _ # _ ӄ ы т в а р к ы н _
ынӈэ акаԓырока энмэч рымагтэты атав мынԓеркын ынӄо эквэтгъэт	а к а ԓ ы р о к а _ # _ р ы м а г т э т ы _ # _ # _ ы н ӄ о _ # _
амъянра нэмэ ӄуԓиникэк ԓьувыԓгык ивнин ытԓенъютэ	н э м э _ # _ ԓ ь у в ы ԓ г ы к _ # _ ы т ԓ е н ъ ю т э _
ынээԓьэ ивнин гытым эквэтгъэт нэмэ амъянра	и в н и н _ г ы т ы м _ э к в э т г ъ э т _ # _ а м ъ я н р а _
нотагты гаԓгоратваԓенат нэмэ эԓьувыԓгыкэ ӄуԓиникэк нэмэ	г а ԓ г о р а т в а ԓ е н а т _ # _ э ԓ ь у в ы ԓ г ы к э _ # _ н э м э _
ԓьувыԓгыгъэт нэмэ йынатъёоӈӈонэн ытԓенъютэ умиԓгу нинивӄин ынӈатаԓым	н э м э _ # _ # _ у м и ԓ г у _ н и н и в ӄ и н _ ы н ӈ а т а ԓ ы м _
эты игыр тыйъогыр умиԓгу нычимгъуӄин нивӄин нинивӄин	и г ы р _ т ы й ъ о г ы р _ # _ н ы ч и м г ъ у ӄ и н _ н и в ӄ и н _ н и н и в ӄ и н _
ытԓенъютэ умиԓгунэ ивнин вынэ эвыр опопы амыным моогъат	у м и ԓ г у н э _ и в н и н _ в ы н э _ э в ы р _ о п о п ы _ # _ # _
тэйкэвкы иам нэнагнатъёоӄэн ынээԓьын тутъыԓӄутынэ миӈкыри ӄун	и а м _ н э н а г н а т ъ ё о ӄ э н _ # _ т у т ъ ы ԓ ӄ у т ы н э _ # _ ӄ у н _
ытԓён ёргэты ваԓьын чама	ё р г э т ы _ # _ ч а м а _
тотъэты ваԓьын ынкъам ынӄэната ынээԓьын нэнагнатӄэн	ваԓьын _ ы н к ъ а м _ ы н ӄ э н а т а _ ы н э э ԓ ь ы н _ # _
ԓыгэн ӄун ёргэты ваԓьын	ӄ у н _ ё р г э т ы _ # _
аны нинэнтэйкэвэтӄин ынээԓьэ аны ӄэйвэ гэԓгэрмэвӄээтԓин тутъыԓӄутӄэй	н и н э н т э й к э в э т ӄ и н _ # _ а н ы _ ӄ э й в э _ г э ԓ г э р м э в ӄ э э т ԓ и н _ # _
рыпэт	
ӄун нутэсӄын ӄынур ыԓьыԓ 	н у т э с ӄ ы н _ ӄ ы н у р _ # _ # _
гыткат ӈэнри нунрэпэтӄинэт миԓгунэ	ӈ э н р и _ # _ # _
эннэпы эйминнин ынкъам нинэтиӈуткуӄин ыныкаӈӄачагты	э й м и н н и н _ # _ н и н э т и ӈ у т к у ӄ и н _ # _
аны ныкытъыматыԓьатӄэн тутъыԓӄут 	н ы к ы т ъ ы м а т ы ԓ ь а т ӄ э н _ # _ _
ытԓенъюӄэй ԓюур ръэнут пэгԓягъэ ԓыгэн	ԓ ю у р _ р ъ э н у т _ п э г ԓ я г ъ э _ ԓ ы г э н _
эвыр ынкэӄэй пэӄэттатгъэ ытԓеӈи ӄытԓыги ытԓенъюн	ы н к э ӄ э й _ п э ӄ э т т а т г ъ э _ # _ ӄ ы т ԓ ы г и _ # _
гыткаԓгын рыйыԓгынтэннин аны гакапчачавԓен	р ы й ы ԓ г ы н т э н н и н _ # _ г а к а п ч а ч а в ԓ е н _
умиԓгу чама гэейвэчетԓин тотъытԓянъёгты ынӄо рырагтаннэн нотайпы	ч а м а _ г э е й в э ч е т ԓ и н _ # _ ы н ӄ о _ р ы р а г т а н н э н _ н о т а й п ы _
имтитэ ытԓыгэ пынԓёнэн авъеткынка нытваӄэн умиԓгу ынӄо ытԓеӈи иквъи ынӄо	ы т ԓ ы г э _ п ы н ԓ ё н э н _ а в ъ е т к ы н к а _ # _ у м и ԓ г у _ # _ ы т ԓ е ӈ и _ # _ # _
ытԓыгын иквъи ынӄо умиԓгу нэмэ эквэтгъи ытԓеӈиым ярак пэԓятгъэ ярак	и к в ъ и _ ы н ӄ о _ у м и ԓ г у _ # _ э к в э т г ъ и _ ы т ԓ е ӈ и ы м _ # _ п э ԓ я т г ъ э _ я р а к _
гаԓгоратъыԓытваԓен тутъыԓӄут ынӄо мэԓеквъи тутъыԓӄут ԓыгэн эвыр	т у т ъ ы ԓ ӄ у т _ ы н ӄ о _ м э ԓ е к в ъ и _ # _ ԓ ы г э н _ э в ы р _
эквэтгъи нотагты тутъыԓӄут аны горатваԓен тутъыԓӄут рэрмэвӈык	н о т а г т ы _ т у т ъ ы ԓ ӄ у т _ # _ г о р а т в а ԓ е н _ т у т ъ ы ԓ ӄ у т _ # _
ӄынвэр нэмэ ԓюур ԓьувыԓгыгъэт гэнээԓьэ ынкы	н э м э _ ԓ ю у р _ ԓ ь у в ы ԓ г ы г ъ э т _ # _ # _
ынээԓьын гаԓгэкоргавԓен ынӄо	г а ԓ г э к о р г а в ԓ е н _ # _
ивнин умиԓгунэ ытԓеӈи ынӄэным	у м и ԓ г у н э _ # _ ы н ӄ э н ы м _
виин раԓьонъёно	р а ԓ ь о н ъ ё н о _
мыныԓгын энмэч виин ёпынвыӈаеты	э н м э ч _ в и и н _ ё п ы н в ы ӈ а е т ы _
мынытԓепыткусӄивмык ёпынвыӈаеты эквэтгъэт	ё п ы н в ы ӈ а е т ы _ э к в э т г ъ э т _
гэтԓенъютэ аны	а н ы _
ынкы гапэрӄытваԓенат ёпынвыӈайгэӈкы	г а п э р ӄ ы т в а ԓ е н а т _ # _
ԓюур рай ӄоԓ	р а й _ ӄ о ԓ _
ёпыԓӄэвыԓьын ёпынвыӈаеты	ё п ы н в ы ӈ а е т ы _
аны ԓыгэн ӄынур йъаяӄ ныԓеӄин наӄам	ԓ ы г э н _ ӄ ы н у р _ й ъ а я ӄ _ # _ # _
иԓгиръыԓьын ынӄэн ёпыԓӄэвыԓьын	ы н ӄ э н _ ё п ы ԓ ӄ э в ы ԓ ь ы н _
торъаатчек туринъытвиԓьын ынӄо ынӄэн	т у р и н ъ ы т в и ԓ ь ы н _ ы н ӄ о _ ы н ӄ э н _
оравэтԓьан кытэӄэй ынкы	к ы т э ӄ э й _ ы н к ы _
вагъэ ынӄо эквэтгъи ынӄо нэмэ	ы н ӄ о _ э к в э т г ъ и _ ы н ӄ о _ н э м э _
ӄоԓ пыкиргъи ёпынвыӈаеты ынраӄ	п ы к и р г ъ и _ # _ # _
ытԓенъютэ нинивӄин ынээԓьын нинивӄин умиԓгунэ наӄам мэрынрэӄэй	н и н и в ӄ и н _ ы н э э ԓ ь ы н _ # _ # _ # _ м э р ы н р э ӄ э й _
нывэтгавӄэнат ытри нинивӄин ытԓенъютэ ӄынвэр эквэтгъи	ы т р и _ # _ # _ # _ э к в э т г ъ и _
ԓюур ӄуԓиникэк коԓё пыкитчыӄиквъи оравэтԓьан ӄынур кэйӈын аны	ӄ у ԓ и н и к э к _ # _ # _ # _ ӄ ы н у р _ # _ # _
ынӄэн ытԓенъюӄэй наӄамԓым ԓыгайыԓгавыԓьатыӈӈой ынӄо ытԓён нивӄин ынӄэн	ы т ԓ е н ъ ю ӄ э й _ # _ ԓ ы г а й ы ԓ г а в ы ԓ ь а т ы ӈ ӈ о й _ ы н ӄ о _ ы т ԓ ё н _ н и в ӄ и н _ ы н ӄ э н _
умиԓгу аны ытԓеӈи найыԓгавӄэн ытԓенъютэ	а н ы _ ы т ԓ е ӈ и _ # _ # _
нинивӄин ынӄо ивнин ытԓеӈи	ы н ӄ о _ # _ ы т ԓ е ӈ и _
эвыр рэнанмыгъа гым ынӈэ гыт вэты ӄун урэвкэ ԓыгэн ӄонпы ынкы	р э н а н м ы г ъ а _ # _ ы н ӈ э _ г ы т _ в э т ы _ # _ # _ # _ ӄ о н п ы _ ы н к ы _
ӄатчытваркын вытку рэквэтгъэ ытԓён ынкы	в ы т к у _ р э к в э т г ъ э _ # _ # _
вытку ӄэквэтги	ӄ э к в э т г и _
ярагты ынкъам ытԓыгын ӄынымӈыԓяквын аны ӈан эчги ёпынвыӈайык	ы н к ъ а м _ ы т ԓ ы г ы н _ ӄ ы н ы м ӈ ы ԓ я к в ы н _ # _ ӈ а н _ э ч г и _ ё п ы н в ы ӈ а й ы к _
тыттэтгъи танӈармайӈын аны гапэнрыԓен умиԓгунэ ынӄо ԓыгэн	т а н ӈ а р м а й ӈ ы н _ # _ г а п э н р ы ԓ е н _ у м и ԓ г у н э _ # _ ԓ ы г э н _
эвыр ивнин танӈармайӈа умиԓгу аны гапэнрыԓен умиԓгунэ	и в н и н _ # _ # _ а н ы _ г а п э н р ы ԓ е н _ у м и ԓ г у н э _
ынӄо ԓыгэн эвыр ивнин танӈармайӈа умиԓгу аны ынраӄ моонэн пынԓёк танӈармайӈа ынӄо ивнин	ԓ ы г э н _ э в ы р _ и в н и н _ # _ # _ а н ы _ ы н р а ӄ _ м о о н э н _ # _ т а н ӈ а р м а й ӈ а _ # _ и в н и н _
умиԓгунэ танӈармайӈын чеӈэрым мытԓьувыԓгымык аны гамгоԓенат пойгыԓьатык таӈымъыԓёӈэт	т а н ӈ а р м а й ӈ ы н _ ч е ӈ э р ы м _ м ы т ԓ ь у в ы ԓ г ы м ы к _ а н ы _ г а м г о ԓ е н а т _ # _ т а ӈ ы м ъ ы ԓ ё ӈ э т _
гамаравԓенат инъэ моогъат маравкы	и н ъ э _ м о о г ъ а т _ м а р а в к ы _
наӄам ёпынвыӈайкэн ԓявтыткын ныԓгинычьувӄин эрвъэӈэты ваԓьын таӈымъыԓёӈэт	ё п ы н в ы ӈ а й к э н _ # _ н ы ԓ г и н ы ч ь у в ӄ и н _ э р в ъ э ӈ э т ы _ в а ԓ ь ы н _ т а ӈ ы м ъ ы ԓ ё ӈ э т _
гапойгыԓьатԓенат умиԓгу ытри танӈармачьиӈын ԓюур воԓӄытвэма тэкэм	у м и ԓ г у _ ы т р и _ т а н ӈ а р м а ч ь и ӈ ы н _ # _ в о ԓ ӄ ы т в э м а _ # _
тиркытир нивтытвиӄин ынкы ԓюур почьакагыргык выквагъэ пойгырынрыянвыкэн поӄыткын	н и в т ы т в и ӄ и н _ # _ ԓ ю у р _ п о ч ь а к а г ы р г ы к _ # _ п о й г ы р ы н р ы я н в ы к э н _ п о ӄ ы т к ы н _
танӈармачьиӈэн ынӄо ԓыгэн	ы н ӄ о _ ԓ ы г э н _
эвыр пэӄэттатгъэ ынӄо иквъи энантэнмаквъэ энанмыгъэ энмэч	п э ӄ э т т а т г ъ э _ # _ и к в ъ и _ э н а н т э н м а к в ъ э _ # _ э н м э ч _
ӄэнатаӈынмыгэ этки танӈыӈавыйӈа гагтойгым	э т к и _ т а н ӈ ы ӈ а в ы й ӈ а _ # _
майӈыпочьакагыргыԓьо ынӄо тымнэн умиԓгынэ танӈармайӈын ынӄэнына	ы н ӄ о _ т ы м н э н _ у м и ԓ г ы н э _ # _ ы н ӄ э н ы н а _
танӈармайӈа танԓымынӄо ниниткэйвыӄинэт ӈэԓвыԓьыт	т а н ԓ ы м ы н ӄ о _ н и н и т к э й в ы ӄ и н э т _ # _
ынкъам ынанармачьо	ы н а н а р м а ч ь о _
нитӄин ынӄэнайӈын наӄам ынин маравратчыӈын ныԓгинымкыӄин коԓё ԓыгэгаймычьыԓьыйӈо гатваԓен ынӄэнайӈын миӈкыри ӄун танԓымынӄо гаӄороткоԓьатԓен чама маравтомга нинэпириԓьэтӄинэт ӈочьыткойпы	ы н ӄ э н а й ӈ ы н _ # _ ы н и н _ м а р а в р а т ч ы ӈ ы н _ # _ к о ԓ ё _ # _ # _ ы н ӄ э н а й ӈ ы н _ # _ ӄ у н _ т а н ԓ ы м ы н ӄ о _ г а ӄ о р о т к о ԓ ь а т ԓ е н _ # _ м а р а в т о м г а _ # _ ӈ о ч ь ы т к о й п ы _
ачак ынӄэнына ганмыԓен умиԓгуӄэйынэ аны ынӄэн ынкы пойгыԓьанма	ы н ӄ э н ы н а _ г а н м ы ԓ е н _ у м и ԓ г у ӄ э й ы н э _ # _ ы н ӄ э н _ ы н к ы _ п о й г ы ԓ ь а н м а _
ымъыԓёӈэт гапаӈъэватычгатԓен	г а п а ӈ ъ э в а т ы ч г а т ԓ е н _
танӈармачьын энмэч еԓычгын ганточгатԓен ныкэнчиӄыткуӄин	э н м э ч _ е ԓ ы ч г ы н _ # _ # _
ынӄо йъонэн ивтыԓ	й ъ о н э н _ # _
ваԓьын ытԓеӈи ынӄо ивнин ынинэԓьэ	ы т ԓ е ӈ и _ # _ # _ ы н и н э ԓ ь э _
ынӄо	
рагтыгъат гэнээԓьэ	г э н э э ԓ ь э _
ынкы ӄэйыӄын паӈъэвӈытотвагъат гэтԓенъютэ ынӄо	ӄ э й ы ӄ ы н _ п а ӈ ъ э в ӈ ы т о т в а г ъ а т _ # _ ы н ӄ о _
эквэтгъэт	
ны ынраӄ ынкы ныԓӄырирӄинэт ыргинэт	ы н р а ӄ _ ы н к ы _ н ы ԓ ӄ ы р и р ӄ и н э т _ # _
йъэԓгытомгыт ынкъам	ы н к ъ а м _
ӄынвэр нэԓьунэт	н э ԓ ь у н э т _
ыннэн йъэԓгытомгын ныԓгэнымԓыӄэн	й ъ э ԓ г ы т о м г ы н _ # _
ыниным нынны пэрӄыё ыргиным гыттэпычьын	н ы н н ы _ п э р ӄ ы ё _ # _ г ы т т э п ы ч ь ы н _
нытваӄэн ымы	ы м ы _
ӄытԓыги энмэч ынин нынны вэтгавчьомыԓьо ытри	э н м э ч _ # _ н ы н н ы _ в э т г а в ч ь о м ы ԓ ь о _ # _
нытваӄэнат эннысӄыткынык пыкиргъэт ынкы ԓыгэн эвыр эԓкыԓнинэт вэтгавчьомыԓьона ытԓывъёт	э н н ы с ӄ ы т к ы н ы к _ # _ ы н к ы _ ԓ ы г э н _ э в ы р _ э ԓ к ы ԓ н и н э т _ # _ ы т ԓ ы в ъ ё т _
ивнинэт ынӄо ивнинэт вэтгавчьомыԓьона	ы н ӄ о _ # _ в э т г а в ч ь о м ы ԓ ь о н а _
энмэч пэтԓе рэпкирӈыт	п э т ԓ е _ # _
рынноԓьыт аны ынкы	а н ы _ ы н к ы _
гатэнмавԓенат маравынвэты ымы	м а р а в ы н в э т ы _ ы м ы _
ынӄэн пэрӄыён томгымкычгын опопы гым виин ёпынвыӈаеты мыёпыԓӄэвык эквэтгъи	п э р ӄ ы ё н _ # _ о п о п ы _ г ы м _ в и и н _ ё п ы н в ы ӈ а е т ы _ # _ э к в э т г ъ и _
умиԓгу ёпыԓӄэвынвэты аны	ё п ы ԓ ӄ э в ы н в э т ы _ а н ы _
ёпынвыӈайыткынык гаёпытваԓен ԓюур рай тэкэм тэркэвтытвэма мооԓьычгын ӈоонӄо ининигъи ынкы атчыгъэ тумгэӄэй	г а ё п ы т в а ԓ е н _ ԓ ю у р _ р а й _ т э к э м _ # _ # _ ӈ о о н ӄ о _ и н и н и г ъ и _ # _ # _ # _
умиԓгу ԓюур ынкы тэкэм	ԓ ю у р _ ы н к ы _ # _
ёпынвыӈайык ӄача вуԓӄытвининэт	ӄ а ч а _ в у ԓ ӄ ы т в и н и н э т _
мууԓьыт нкы гаманэгранпатԓенат ынӄо эчги тэӈвуԓӄытвигъи ӄытгъи манэграԓьэты аны	н к ы _ г а м а н э г р а н п а т ԓ е н а т _ ы н ӄ о _ э ч г и _ т э ӈ в у ԓ ӄ ы т в и г ъ и _ # _ м а н э г р а ԓ ь э т ы _ # _
умиԓгунэ гачамэттаԓенат манэграԓьыт ӄынвэр пыкиргъи манэграԓьык	г а ч а м э т т а ԓ е н а т _ м а н э г р а ԓ ь ы т _ ӄ ы н в э р _ п ы к и р г ъ и _ м а н э г р а ԓ ь ы к _
винвэӄэй ԓюнԓьутэ нынтыӄин эӄэԓьэ ԓюур ынкы вэнвыпаԓёмтэԓгъэ манэграгэӈкы ынкы нивӄинэт	ԓ ю н ԓ ь у т э _ н ы н т ы ӄ и н _ э ӄ э ԓ ь э _ # _ ы н к ы _ # _ # _ ы н к ы _ н и в ӄ и н э т _
ытри амыным атав игыр ныкитэ мынчамэттанат умиԓгун	а м ы н ы м _ # _ # _ # _ м ы н ч а м э т т а н а т _ # _
рэмкын ынӄэнат рынноԓьыт омэԓгона миӈкыри	ы н ӄ э н а т _ # _ # _ м и ӈ к ы р и _
ӄун ынан ганмыԓен ыргин ынанармачьын танӈармайӈын эчгиым ынӈин ивыпԓыткугъэт	ы н а н _ г а н м ы ԓ е н _ ы р г и н _ # _ # _ э ч г и ы м _ ы н ӈ и н _ и в ы п ԓ ы т к у г ъ э т _
эӄэԓьыт винвэӄэй	в и н в э ӄ э й _
эквэтгъи	
ярагты ынӄо яраԓьыт	ы н ӄ о _ # _
ивнинэт миӈкъым ԓьунэт эӄэԓьыт	м и ӈ к ъ ы м _ # _ # _
ынӄо вэтгавчьомыԓьо иквъи	в э т г а в ч ь о м ы ԓ ь о _ # _
ӄуттиым пытӄырымагты	п ы т ӄ ы р ы м а г т ы _
натчынат	
ӈаԓгыԓ ӄэнъевык гаԓгатчыръоԓенат	ӄ э н ъ е в ы к _ # _
гъыттъыма аны ԓюур нымгутыԓеӄинэт	а н ы _ ԓ ю у р _ н ы м г у т ы ԓ е ӄ и н э т _
вусӄымчыку коԓё ныԓгинымэйыӈӄин мооԓьиӈын ныԓеӄин ӄанъявэчгэтты ԓюур эчги	к о ԓ ё _ # _ # _ # _ ӄ а н ъ я в э ч г э т т ы _ # _ э ч г и _
ынанэвтыԓяӈӄач ваԓьакы мачгаԓяк ивтытԓьэтэ нъыттъытриԓынэт аны гиинъыттъыт гапэнрыткоԓенат	в а ԓ ь а к ы _ м а ч г а ԓ я к _ и в т ы т ԓ ь э т э _ н ъ ы т т ъ ы т р и ԓ ы н э т _ а н ы _ г и и н ъ ы т т ъ ы т _ # _
моогты аны	а н ы _
гэръиԓеԓин мооԓьыйӈын ораыттъыёԓягты ынӄо	м о о ԓ ь ы й ӈ ы н _ о р а ы т т ъ ы ё ԓ я г т ы _ ы н ӄ о _
намгогъан танԓымынӄо ыттъытриԓьюук аны	т а н ԓ ы м ы н ӄ о _ ы т т ъ ы т р и ԓ ь ю у к _ # _
ыттъыт гаӄоԓема	г а ӄ о ԓ е м а _
гапэнрыткоръоԓенат	
ынкы мууриԓ гэкымъугчитԓин чинит ирвык	м у у р и ԓ _ # _ ч и н и т _ и р в ы к _
ӄэтвэтръугъэт таӈымыԓьо эвыр эквырга чымӄык гэегтэтԓинэт ынӄэнат ыргынан нэпиринэт маравтомго ынӄо нымытваӈӈогьат	т а ӈ ы м ы ԓ ь о _ э в ы р _ # _ # _ # _ # _ ы р г ы н а н _ # _ # _ # _ н ы м ы т в а ӈ ӈ о г ь а т _
рымагтэты таӈӄонпы ытри	т а ӈ ӄ о н п ы _ # _
нотагты ӄытыԓьэтыԓьыт пэниннэт рачвыӈыԓьыт с ӈаԓвыԓьиӈын	ӄ ы т ы ԓ ь э т ы ԓ ь ы т _ # _ р а ч в ы ӈ ы ԓ ь ы т _ с _ ӈ а ԓ в ы ԓ ь и ӈ ы н _
ыргин аръаԓя ныԓгинымкыӄин рыпэт	а р ъ а ԓ я _ # _ # _
ынанчинит ԓейвэ	ԓ е й в э _
итыԓьын энмэн ганымытваԓенат тэӈыннэнчеэкэй	э н м э н _ # _ т э ӈ ы н н э н ч е э к э й _
чавчывамкиӈын ԓыгэн	ԓ ы г э н _
ӄун	
ныԓгинымкыӄин рагэнэвчыӈын	р а г э н э в ч ы ӈ ы н _
ӈаԓвыԓьиӈын ыргин аръаԓя ныԓгинымкыӄин	ы р г и н _ а р ъ а ԓ я _ # _
рыпэт ынанчинит ԓейвэ итыԓьын	ы н а н ч и н и т _ # _ # _
аны отчой ганымытваԓенат ынӄэнат	о т ч о й _ г а н ы м ы т в а ԓ е н а т _ # _
рамкиӈын ынраӄ ӄоԓ гатваԓен ынин нынны мотԓынто ынӄэн оравэтԓьан энмэч рэтинэнъэӄэӈгъэ ӄоԓ итык вуԓӄытвик гараеквэԓен мотԓынто ԓыгэн	ы н р а ӄ _ ӄ о ԓ _ г а т в а ԓ е н _ ы н и н _ н ы н н ы _ м о т ԓ ы н т о _ # _ о р а в э т ԓ ь а н _ э н м э ч _ # _ # _ и т ы к _ в у ԓ ӄ ы т в и к _ # _ # _ ԓ ы г э н _
танъямгарайпы ныпаԓёмтэԓгэԓеӄэн ԓюур	н ы п а ԓ ё м т э ԓ г э ԓ е ӄ э н _ ԓ ю у р _
ӄоԓераӄайык паԓёмтэԓгъэ тэкэм ынраӄ	п а ԓ ё м т э ԓ г ъ э _ т э к э м _ ы н р а ӄ _
ӈъочьыраӄайык эвын ынкы ыргин	э в ы н _ ы н к ы _ ы р г и н _
ытԓыгын нэмыӄэй нытваӄэн ныпавӄэнат	н э м ы ӄ э й _ # _ # _
ӈирэӄ ӈъочьыӈэнӄайӄагтэ ӈан ӄаамотԓя	ӈ ъ о ч ь ы ӈ э н ӄ а й ӄ а г т э _ # _ ӄ а а м о т ԓ я _
вуԓӄытвик наӄам ынӄэн ыргин ытԓыгын	н а ӄ а м _ # _ ы р г и н _ ы т ԓ ы г ы н _
ӈъочьо гитԓин тъарӄааԓьо ԓюур вай мотԓынто	г и т ԓ и н _ т ъ а р ӄ а а ԓ ь о _ ԓ ю у р _ в а й _ м о т ԓ ы н т о _
рагтыгъэ ынкъам	ы н к ъ а м _
яраԓьыт ивнинэт тав эӄыԓпэ мынынръэйвэвын мургин яраӈы ынкъам мынгынтэв нотаӄаԓеты эӄыԓпэ	и в н и н э т _ # _ # _ м ы н ы н р ъ э й в э в ы н _ # _ я р а ӈ ы _ ы н к ъ а м _ м ы н г ы н т э в _ # _ э ӄ ы ԓ п э _
нэнръэйвэвын яраӈы ынраӄ нэчвиркын чымӄык ӈэԓвыԓ	я р а ӈ ы _ ы н р а ӄ _ # _ # _ ӈ э ԓ в ы ԓ _
ԓыгэӄыԓпэ нэчвигъэн ӈэԓвыԓ мачамчымӈы ынӄо гэмгутыԓеԓинэт ԓыгэн	н э ч в и г ъ э н _ # _ # _ # _ г э м г у т ы ԓ е ԓ и н э т _ # _
нотаӄаԓеты киткитым анымкычаӈэты ӄэйыӄын	к и т к и т ы м _ а н ы м к ы ч а ӈ э т ы _ ӄ э й ы ӄ ы н _
ынкы гатчытваԓен мотԓынто эчги	г а т ч ы т в а ԓ е н _ # _ э ч г и _
эмгынунныкитэ нъэԓгъи	н ъ э ԓ г ъ и _
тумгэӄэй мотԓынтоӄай гаваӈэйпаратԓен гамгарайпы	м о т ԓ ы н т о ӄ а й _ # _ г а м г а р а й п ы _
нивӄин ик энмэн рэмкын	и к _ # _ р э м к ы н _
вай ӄорачетыркын нивӄинэт	ӄ о р а ч е т ы р к ы н _ # _
энараԓьыт мургинэт ӄутти	м у р г и н э т _ ӄ у т т и _
ик амын	а м ы н _
ивкэ мыниткэчитыркын ӈэԓвыԓ ӄытԓыгиым ынӄэн	м ы н и т к э ч и т ы р к ы н _ # _ ӄ ы т ԓ ы г и ы м _ # _
гъыръунтэтԓин мотԓынто аны	м о т ԓ ы н т о _ а н ы _
ынкы турӄуԓиԓьыръук мотԓынто	т у р ӄ у ԓ и ԓ ь ы р ъ у к _ # _
гэԓӄутръуԓинэт гамгараеквэйӈын ԓыгэн ӈытоԓьын гапойгыма нынторъоӄэнат	г а м г а р а е к в э й ӈ ы н _ ԓ ы г э н _ ӈ ы т о ԓ ь ы н _ # _ # _
чиӈивэӄ гатэӈорма ынкы нымэйыӈӄин майӈымарав гатваԓен ԓыгэӄыԓпэ	г а т э ӈ о р м а _ ы н к ы _ н ы м э й ы ӈ ӄ и н _ # _ # _ ԓ ы г э ӄ ы ԓ п э _
нэчвиткуйвын ӈаԓвыԓьиӈын ԓыгэн ӄун тымӈэнӈэн	ӈ а ԓ в ы ԓ ь и ӈ ы н _ ԓ ы г э н _ ӄ у н _ т ы м ӈ э н ӈ э н _
нытымӈэчвэткойвыӄэн чымӄыкым ԓыгэн оравэтԓьат нынмыткойвыӄэнат ынкы	ч ы м ӄ ы к ы м _ ԓ ы г э н _ о р а в э т ԓ ь а т _ # _ # _
ԓыгэн ӄаачыко	ӄ а а ч ы к о _
ԓымӈэ ярак ӄача ӄынвэр тэӈуйӈэ	я р а к _ ӄ а ч а _ ӄ ы н в э р _ # _
нъэԓгъи арака эвыр	а р а к а _ # _
ӈэԓвыԓ тэӈыннэн ԓёӈпэԓята итгъи ӄораӈы вачаӄым ӄытԓыги ынкы ӄоԓ гапэԓятԓен	т э ӈ ы н н э н _ # _ и т г ъ и _ ӄ о р а ӈ ы _ # _ # _ # _ ӄ о ԓ _ г а п э ԓ я т ԓ е н _
яраӈы раԓӄаӈынвык аны ӄынур пырӄаквыԓгын гэтэйкыԓин гаԓгэнъомравԓен аӄанчемавкы ваԓьын	р а ԓ ӄ а ӈ ы н в ы к _ # _ # _ п ы р ӄ а к в ы ԓ г ы н _ # _ г а ԓ г э н ъ о м р а в ԓ е н _ # _ в а ԓ ь ы н _
ӄытԓыги ынкы ӈирэӄ оравэтԓьат	ы н к ы _ ӈ и р э ӄ _ # _
гэтуйвынԓинэт гэӈээккэтэ ԓюур	г э ӈ э э к к э т э _ ԓ ю у р _
пыкиргъи этратчыӈын рыркаӈэԓгиӈа	э т р а т ч ы ӈ ы н _ # _
нъэԓгынтакаӈатын ынӄэн яраӈы натаӈыԓвавын	ы н ӄ э н _ я р а ӈ ы _ н а т а ӈ ы ԓ в а в ы н _
рыпирӄык ымы ынраӄ намгон	ы м ы _ ы н р а ӄ _ # _
ивкы ынкы рыйигрывъэтэ	ы н к ы _ р ы й и г р ы в ъ э т э _
мытрэнтыгыт ынпыначгыӄай ночыткоӄэн ынӄо высӄу нытчыӄин ынӄо нэмэ иквъэт ынпыначгыӄай	ы н п ы н а ч г ы ӄ а й _ н о ч ы т к о ӄ э н _ # _ в ы с ӄ у _ # _ ы н ӄ о _ н э м э _ и к в ъ э т _ # _
нивӄин гымнин йъэԓгытомгыт таӈатӄэԓгычайвыркыт ытръэч тэӈӄырым	г ы м н и н _ й ъ э ԓ г ы т о м г ы т _ # _ # _ т э ӈ ӄ ы р ы м _
ӄыԓьугыткы ынӄо ытри	ы н ӄ о _ ы т р и _
иквъэт ынин варкыт эвыӈан йъэԓгытомгыт ынраӄым	ы н и н _ # _ # _ # _ # _
ръэмиӈкы кытъаткэ ынӄо эквэтгъэт ӄырэрынво ынӄэн ынӄэнат	к ы т ъ а т к э _ ы н ӄ о _ # _ ӄ ы р э р ы н в о _ # _ ы н ӄ э н а т _
ынӄэнатым гэӈээккэтэ нымытваӈӈогъат ынкы ӄынвэр ӄоԓ	г э ӈ э э к к э т э _ # _ # _ # _ # _
итык вуԓӄытвик иквъи ынпыначгыӄай ӈааккагты ынӄо ынпыначгыӄая ԓёнтатԓыӈа	в у ԓ ӄ ы т в и к _ # _ ы н п ы н а ч г ы ӄ а й _ ӈ а а к к а г т ы _ # _ ы н п ы н а ч г ы ӄ а я _ # _
рыннин ытръэч ивнин гэквэтԓинэт ԓыгэн ынӈин высӄумчыку наӄам ԓыгэн ныԓгитымгыпиӈэтӄин ныпыӈкытԓетӄин аны котчой	ы т р ъ э ч _ и в н и н _ # _ # _ ы н ӈ и н _ в ы с ӄ у м ч ы к у _ # _ ԓ ы г э н _ н ы ԓ г и т ы м г ы п и ӈ э т ӄ и н _ # _ а н ы _ к о т ч о й _
гэԓеԓинэт ԓыгэн нотагты наӄам	ԓ ы г э н _ н о т а г т ы _ н а ӄ а м _
ынпыначгыӄай ныянотыԓьатӄэн ӈээккэтэ	н ы я н о т ы ԓ ь а т ӄ э н _ # _
наӄам	
гэмо миӈкыри тыԓеркыт ԓюур	м и ӈ к ы р и _ # _ # _
вай янотыԓьын	я н о т ы ԓ ь ы н _
ръэгъи нэмыӄэй ытԓён	н э м ы ӄ э й _ # _
гэмо ԓыгнин ынан	ԓ ы г н и н _ ы н а н _
ӈэвысӄэтэ эвын ԓыԓепгъи	э в ы н _ # _
ӄытԓыги энмэпы	э н м э п ы _
гэкэмчичьэтԓинэт ынпыначгыӄай	ы н п ы н а ч г ы ӄ а й _
йъонэн ӈээккэтэ 	ӈ э э к к э т э _ # _
эвын гэтъымымчеткуԓьэтԓин ынпыначгыӄай иквъи эвыр	г э т ъ ы м ы м ч е т к у ԓ ь э т ԓ и н _ # _ и к в ъ и _ э в ы р _
ӈэнку рэпкиргъэ	р э п к и р г ъ э _
ӄымӈыԓтэԓгэ каракэгты ымыԓьо вагыргын ӄытвыԓьатгын нкъам ынан	к а р а к э г т ы _ ы м ы ԓ ь о _ в а г ы р г ы н _ # _ # _ ы н а н _
авык ыргынан ӄонпы нэрэтчыгыт таԓвапаԓӄаттагнэты ээ энмэч	ы р г ы н а н _ ӄ о н п ы _ # _ # _ # _ э н м э ч _
гым ԓымӈэ рымагтэты	ԓ ы м ӈ э _ # _
аӄаягтаԓы тытваркын ԓыгэн ынӈин ивыпԓыткук въигъи ынпыначгыӄай	т ы т в а р к ы н _ ԓ ы г э н _ # _ и в ы п ԓ ы т к у к _ в ъ и г ъ и _ # _
миӈкыри ӄун ԓымӈэ ӄэйвэ аӄаягтаԓы эвын	ӄун _ ԓ ы м ӈ э _ # _ # _ # _
миӈкы гэԓгитъымымчеткуԓин ээ	г э ԓ г и т ъ ы м ы м ч е т к у ԓ и н _ # _
ынӄэным амынан нъэԓгъи	а м ы н а н _ # _
ӈэвысӄэт наӄам	н а ӄ а м _
ытԓыгын въигъи ытԓёным рыгъеватыԓӄаӈынвыгъет атав эквэтгъи аны	в ъ и г ъ и _ # _ # _ # _ э к в э т г ъ и _ # _
котчой гэԓеԓин ӄооӈ ԓыгэн гэмо	г э ԓ е ԓ и н _ ӄ о о ӈ _ # _ # _
миӈкыри ӄынвэр вай ԓюур оравэтԓьан ӈытоԓьын ԓьунин ӈэвысӄэтэ ԓыгэным ынӄэн	ӄ ы н в э р _ # _ ԓ ю у р _ о р а в э т ԓ ь а н _ # _ # _ # _ # _ # _
ԓьоо оравэтԓьан ынӄэн ԓьунэӈу	о р а в э т ԓ ь а н _ # _ # _
гэрэсӄивысӄычетԓин ченэтрачыкогты ынӄо нычимгъуӄин ӈэвысӄэт ынръа ӈан мэӈӄокэн оравэтԓьаӄай	ч е н э т р а ч ы к о г т ы _ ы н ӄ о _ н ы ч и м г ъ у ӄ и н _ # _ # _ # _ м э ӈ ӄ о к э н _ # _
наӄам ԓыгэӄыԓпэ	ԓ ы г э ӄ ы ԓ п э _
рэсӄиквъи ынкэгйит	ы н к э г й и т _
ԓыгэн пыкитчыӄиквъи ивыптэгнык ынӄо пыкиргъи	п ы к и т ч ы ӄ и к в ъ и _ # _ ы н ӄ о _ п ы к и р г ъ и _
ынкы ӄытԓыги ынӄэн кэрэкрэмкын аны	ӄ ы т ԓ ы г и _ # _ к э р э к р э м к ы н _ # _
намӈыԓёйвын ынӄэн ӈэвысӄэт	ы н ӄ э н _ ӈ э в ы с ӄ э т _
гамӈыԓтэтԓен ӈэвысӄэт	ӈ э в ы с ӄ э т _
таӈымыԓьо тывъёонэн	т ы в ъ ё о н э н _
ынин нымытвагыргытымы ынӄэн	н ы м ы т в а г ы р г ы т ы м ы _ # _
ӈан чит ярамкиӈык рээн нымытвагыргын	ч и т _ я р а м к и ӈ ы к _ # _ н ы м ы т в а г ы р г ы н _
ынкъам ымы	ы м ы _
йъэԓгытомгыт тывнэнат ытръэч ӄоон	т ы в н э н а т _ # _ ӄ о о н _
миӈкы варкыт ынкъам	в а р к ы т _ # _
ымы йъэԓгытомгыт тывнэнат ытръэч ӄоон миӈкы	й ъ э ԓ г ы т о м г ы т _ # _ # _ ӄ о о н _ # _
варкыт нивӄинэт кэрэкыт энмэч морыкайпы ӄоԓ нитӄинэт	н и в ӄ и н э т _ # _ # _ м о р ы к а й п ы _ # _ н и т ӄ и н э т _
ныгаԓяӄэнат ынӄо нанатвыгъан ӈэвысӄэт	ы н ӄ о _ # _ # _
ӄуԓиныкитэ пыкиргъи	п ы к и р г ъ и _
гэкэӈвыргыргын нэмэ кэрэкык ӄытԓыгиым	н э м э _ к э р э к ы к _ # _
ӄунԓеԓюн рэмкын ԓюур	р э м к ы н _ # _
вай ӄунԓеԓю ӈэнри ӄытгъи пынԓёнэнат	ӄ у н ԓ е ԓ ю _ # _ # _ п ы н ԓ ё н э н а т _
вынэ вай тургин чакыгэт ӈутку	вай _ т у р г и н _ # _ ӈ у т к у _
ако эԓымӈэ эмъим	эԓымӈэ _ э м ъ и м _
рай этки	э т к и _
вынэ мытрэԓьуӈыркын	м ы т р э ԓ ь у ӈ ы р к ы н _
ынӄо нотасӄычыкогты ӄытгъэт ынӄэнат ымыԓьо иийэ мэй ынӈатаԓым нымэԓьэв ӈэнку	н о т а с ӄ ы ч ы к о г т ы _ # _ # _ # _ и и й э _ # _ ы н ӈ а т а ԓ ы м _ # _ ӈ э н к у _
нынымытваӄэн наӄам	н а ӄ а м _
ԓыгонмычыко ымы	ы м ы _
ӄун ырык	ы р ы к _
ротванвык эвыча наӄам ӈэнку ныԓгэӄэргатӄэн ээкэтэ	э в ы ч а _ н а ӄ а м _ # _ # _ # _
энмэч гъывэӄучитэ ӈэнку нынымытваӄэнат ныԓгиныгтиӈӄин ынин ывэӄуч ыӈко иквъи ӄунԓеԓю ынӄы ӄытваркын нымэԓьэв ынӄэн миӈкы эӄэԓьэ ныԓӄырирӄин чакыгэт	г ъ ы в э ӄ у ч и т э _ # _ н ы н ы м ы т в а ӄ э н а т _ # _ # _ ы в э ӄ у ч _ # _ # _ ӄ у н ԓ е ԓ ю _ # _ # _ н ы м э ԓ ь э в _ # _ # _ # _ # _ ч а к ы г э т _
ынкъам ынӄэната ганатчыӈатԓен	ы н ӄ э н а т а _ г а н а т ч ы ӈ а т ԓ е н _
кэрэкитэ ынкъым гаԓгэкоргавԓен чакыгэт рыпэт ӄун ынӄэн чакэно нинъэйӈэвӄин ӄунԓеԓюнэ	ы н к ъ ы м _ г а ԓ г э к о р г а в ԓ е н _ # _ р ы п э т _ # _ ы н ӄ э н _ ч а к э н о _ # _ ӄ у н ԓ е ԓ ю н э _
амкоргава аԓымы ӄырымэн чакыгэт ытръэч ӈавйъеԓгытомгын	а ԓ ы м ы _ ӄ ы р ы м э н _ # _ # _ # _
ынӄо гэквэтԓин ӄунԓеԓин рэмкын гамаравыԓьатԓен гэмгэԓымынкы	г э к в э т ԓ и н _ ӄ у н ԓ е ԓ и н _ р э м к ы н _ г а м а р а в ы ԓ ь а т ԓ е н _ # _
ӄунԓеԓю миӈкыри ӄун ныԓӄыритъюуӄин ӄунԓеԓюнэ гэмгээӄэԓьэ ынкъам ынӄэната гамаравыԓьатԓен гамгааӄаԓьэты	м и ӈ к ы р и _ # _ н ы ԓ ӄ ы р и т ъ ю у ӄ и н _ # _ г э м г э э ӄ э ԓ ь э _ # _ ы н ӄ э н а т а _ г а м а р а в ы ԓ ь а т ԓ е н _ # _
ӄынвэр энмэч гэԓгинымкэвԓин ынин ӈэԓвыԓ ӄунԓеԓюн	э н м э ч _ г э ԓ г и н ы м к э в ԓ и н _ # _ ӈ э ԓ в ы ԓ _ ӄ у н ԓ е ԓ ю н _
аԓымы чит ӄунԓеԓю нотайпы	ч и т _ ӄ у н ԓ е ԓ ю _ # _
ԓейвэ итыԓьын ԓыгэн ӄун	и т ы ԓ ь ы н _ ԓ ы г э н _ # _
ӈъочьыӄай чит	ч и т _
эквырга нутэк таӈамнымытвата гаԓгэмчытвэԓен чама гэӈэӈытвиԓин чинит	н у т э к _ # _ # _ ч а м а _ г э ӈ э ӈ ы т в и ԓ и н _ # _
ыԓеӄинэт ӈанӄэн нэмэ пытԓяӄ нъэӄэԓьыгынтэвӄинэт ԓюур	ӈ а н ӄ э н _ н э м э _ п ы т ԓ я ӄ _ # _ # _
ынкы тыԓянвык	т ы ԓ я н в ы к _
нэӈыръыԓьун ӄоԓ	ӄ о ԓ _
оравэтԓьан ӄытԓыги	ӄ ы т ԓ ы г и _
нэмыӄэй ԓыгиейвэԓӄэй нэпиригъэнгаӄэтывъэӈӈоԓен эвын нанрагтатын ярак пыкирык наномаатын ынӄэн ӄытԓыги энмэн	ԓ ы г и е й в э ԓ ӄ э й _ # _ э в ы н _ н а н р а г т а т ы н _ # _ пыкирык _ н а н о м а а т ы н _ # _ ӄ ы т ԓ ы г и _ э н м э н _
уӄӄэмӄэй ӄытԓыги нэмыӄэй ԓыгиейвэԓӄэй нэпиригъэнгаӄэтывъэӈӈоԓен эвын нанрагтатын ярак пыкирык наномаатын ынӄэн ӄытԓыги	ӄ ы т ԓ ы г и _ # _ # _ # _ э в ы н _ н а н р а г т а т ы н _ # _ пыкирык _ н а н о м а а т ы н _ # _ ӄ ы т ԓ ы г и _
энмэн уӄӄэмӄэй ԓыгэн	у ӄ ӄ э м ӄ э й _ # _
ӄун ӄунԓэԓюнэ	ӄ у н ԓ э ԓ ю н э _
нутэк тэӈэмԓьуткутэ гэнымкэвԓин ынин	т э ӈ э м ԓ ь у т к у т э _ # _ ы н и н _
итрэтӄэй юур	ю у р _
вай ӄуԓивуԓӄытвик нэмэ	ӄ у ԓ и в у ԓ ӄ ы т в и к _ # _
гакаӈыԓьымкиӈын ныԓячаӄэн	н ы ԓ я ч а ӄ э н _
ынӈатаԓым ныԓгинымкыӄин	н ы ԓ г и н ы м к ы ӄ и н _
ӄытԓыги эӄэԓьын нэмэ ԓыгэн	э ӄ э ԓ ь ы н _ # _ # _
кыткаракэгъет пыкитчыӄиквъэт ынкы	п ы к и т ч ы ӄ и к в ъ э т _ ы н к ы _
пыкиргъэт ынкъам нымӈыԓёӄэнат	ы н к ъ а м _ # _
ванэван ӄыԓьугыткы ӄытвыгыткы гэмо моргынан ымыԓьэты	ӄ ы ԓ ь у г ы т к ы _ # _ г э м о _ м о р г ы н а н _ # _
ӄунԓеԓюн рэмкын вэнԓыги танԓёӈытва нэнтынэт ӄунԓеԓюн рэмкын аԓымы ымы ынкы нытваӄэн ыргин чакыгэт ӈавйъеԓгытомгын эквэтгъи	р э м к ы н _ # _ # _ # _ ӄ у н ԓ е ԓ ю н _ р э м к ы н _ # _ # _ # _ н ы т в а ӄ э н _ ы р г и н _ # _ ӈ а в й ъ е ԓ г ы т о м г ы н _ # _
ынӄэн этратчыӈын	э т р а т ч ы ӈ ы н _
ако ынраӄ ынӄэн	ы н р а ӄ _ ы н ӄ э н _
ръэт нэркыԓейвын ӄунԓеԓюргин юур вай	н э р к ы ԓ е й в ы н _ # _ ю у р _ в а й _
вытратычгатгъэ этратчыӈын ӄунԓеԓю нычимгъуӄин ынӄо нивӄинэт ӄунԓеԓюн тумгыт	э т р а т ч ы ӈ ы н _ ӄ у н ԓ е ԓ ю _ н ы ч и м г ъ у ӄ и н _ # _ # _ # _ # _
ӄунԓеԓюнэ ивнинэт эвнэгынтэвкэ мачынан ынйъомык аны нычимгъуӄин	и в н и н э т _ # _ # _ ы н й ъ о м ы к _ # _ н ы ч и м г ъ у ӄ и н _
ӄунԓеԓю нивӄин	н и в ӄ и н _
ымӈан этъопэԓ миӈкыри мынынтынэт	э т ъ о п э ԓ _ м и ӈ к ы р и _ м ы н ы н т ы н э т _
наӄам ӄунԓеԓюн тумгыт	ӄ у н ԓ е ԓ ю н _ # _
ԓыгитъэркинэт нынныт ыргинэт 	н ы н н ы т _ ы р г и н э т _ _
пэтывтычгын ирэпиӄытъым вэтгавкытувъе чеграйӈо	и р э п и ӄ ы т ъ ы м _ в э т г а в к ы т у в ъ е _ ч е г р а й ӈ о _
ыттъыӄопай риӄуӄӄэй ынкъам уӄӄэмэӄэй ӈан	р и ӄ у ӄ ӄ э й _ ынкъам _ у ӄ ӄ э м э ӄ э й _ # _
нутэк ԓьоо ынкъам ӄутти нэмыӄэй	ԓ ь о о _ # _ # _ н э м ы ӄ э й _
нутэк ԓьооӄагтэ ӄынвэр ивнинэт ӄунԓеԓюнэ ынкъам	ԓ ь о о ӄ а г т э _ # _ и в н и н э т _ ӄ у н ԓ е ԓ ю н э _ # _
ынӈин ӄаанэтԓета	ӄ а а н э т ԓ е т а _
мынԓеркын ытри моогьат ӄаанэтԓетыԓьатык	ы т р и _ м о о г ь а т _ # _
гамгорвэты аны ӈоты	а н ы _ ӈ о т ы _
ԓыгэймэквъэт эӄэԓьыт ӄунԓеԓю гиръытвыԓин	э ӄ э ԓ ь ы т _ ӄ у н ԓ е ԓ ю _ # _
тэӈиръыкэ нъэԓгъи амыным	н ъ э ԓ г ъ и _ а м ы н ы м _
ныԓгитэнтымгэтӄин ӈаргынэн таӈайъыткынка ымы ӄунԓеԓю иръытвинэӈу гаӄъоԓяԓен кытгыргоԓягты ӄынур ины ӄъоԓяпԓыткой	ӈ а р г ы н э н _ т а ӈ а й ъ ы т к ы н к а _ # _ ӄ у н ԓ е ԓ ю _ # _ # _ к ы т г ы р г о ԓ я г т ы _ ӄ ы н у р _ и н ы _ ӄ ъ о ԓ я п ԓ ы т к о й _
нэръэпыӄэн эръэпыма эвыр	э р ъ э п ы м а _ э в ы р _
ныйъэтӄин ӈаргынэн ԓыгэӄыԓпэ рэченма ныпиӈэръуӄин къаԓейпыма 	ӈ а р г ы н э н _ ԓ ы г э ӄ ы ԓ п э _ # _ # _ к ъ а ԓ е й п ы м а _ _
нывъятԓьоӄэн ԓейпыма ныпыԓмыръоӄэн эвыр	ԓ е й п ы м а _ н ы п ы ԓ м ы р ъ о ӄ э н _ э в ы р _
тантэнмавыпԓыткой орвэты ӄытгъи орвык вакъой аны тэнԓыԓечурмэтэ гапыԓмыръочгатԓен вачаӄ вэнԓыги	о р в э т ы _ ӄ ы т г ъ и _ о р в ы к _ # _ а н ы _ т э н ԓ ы ԓ е ч у р м э т э _ # _ в а ч а ӄ _ в э н ԓ ы г и _
ынӈин ныԓеӄинэт ынкъам ныянотӄэн тумгэӄэй ирэпиӄытъым аны ныԓеӄинэт атав ынӈин	н ы ԓ е ӄ и н э т _ ы н к ъ а м _ # _ # _ и р э п и ӄ ы т ъ ы м _ # _ н ы ԓ е ӄ и н э т _ а т а в _ # _
вуԓӄытвий ӄынвэр нывиԓгъэт ынкы ӄунԓеԓюн мараврат ынкы	ӄ ы н в э р _ н ы в и ԓ г ъ э т _ # _ ӄ у н ԓ е ԓ ю н _ # _ # _
нэмэ нымэԓеттыԓеӄин ӈаргынэн ӄунԓеԓюнэ ивнинэт	н ы м э ԓ е т т ы ԓ е ӄ и н _ # _ ӄ у н ԓ е ԓ ю н э _ # _
тумгыт нэмэ ӄунԓеԓюнэ ивнинэт	н э м э _ ӄ у н ԓ е ԓ ю н э _ и в н и н э т _
пэԓӄынтэтгъэт ораяаԓегты ӈоонӄо тыԓек ивнинэт мэрынрэӄэй тумгыт	о р а я а ԓ е г т ы _ # _ т ы ԓ е к _ # _ м э р ы н р э ӄ э й _ # _
мынчамэттанат 	_
ӈаан ныйыԓӄатчаӄэнат тумгиирыкым эвыр ночӄэн ынӄо ӈааанӄо	н ы й ы ԓ ӄ а т ч а ӄ э н а т _ # _ э в ы р _ н о ч ӄ э н _ # _ ӈ а а а н ӄ о _
тыԓек ивнинэт нэмэ	и в н и н э т _ н э м э _
тумгыт эченур ирвыт таӈымыԓьо	э ч е н у р _ # _ т а ӈ ы м ы ԓ ь о _
мынынԓейвынэт юрэӄ ӈаан ыръыйыԓӄэтыркыт эвытԓым виин амыргынан ытръэч	ю р э ӄ _ ӈ а а н _ # _ # _ в и и н _ # _ # _
пойгыт мынынрынэт ик тумгыӄэгти ӄунԓеԓюн айыԓгыкыԓьэнат	м ы н ы н р ы н э т _ и к _ т у м г ы ӄ э г т и _ ӄ у н ԓ е ԓ ю н _ а й ы ԓ г ы к ы ԓ ь э н а т _
нымэԓьэв гатэнмавръоԓенат начамэттанат ынӄэн йыԓӄыԓьыгинив энмэч пыкиргъэт ырык	г а т э н м а в р ъ о ԓ е н а т _ # _ ы н ӄ э н _ й ы ԓ ӄ ы ԓ ь ы г и н и в _ # _ п ы к и р г ъ э т _ # _
эвын ныйыԓӄатчаӄэнат нэмэ ивнинэт	н ы й ы ԓ ӄ а т ч а ӄ э н а т _ # _ и в н и н э т _
ӄунԓеԓюнэ эчги	э ч г и _
мытрэпԓыткуӈынэт майынԓяк ирвыт ынраӄ йыԓӄыԓьыт	м а й ы н ԓ я к _ и р в ы т _ ы н р а ӄ _ й ы ԓ ӄ ы ԓ ь ы т _
мынынмыткойвынат ԓыгэн	ԓ ы г э н _
ынкы орвык ыпэ майынԓяк	о р в ы к _ # _ м а й ы н ԓ я к _
ирвыт ынраӄ йыԓӄыԓьыт мынынмыткойвынат	ы н р а ӄ _ й ы ԓ ӄ ы ԓ ь ы т _ # _
ԓыгэн ынкы	ы н к ы _
орвык ыпэ намгонат ирвыт	ы п э _ н а м г о н а т _ # _
тыгинрыԓьэтык орвэпы ԓыгэн	о р в э п ы _ ԓ ы г э н _
ныԓгэӄэйыԓӄатчаӄэнат аӄаԓьымкычгын нэпԓыткунэт майынԓяк ирвыт ынӄо	а ӄ а ԓ ь ы м к ы ч г ы н _ н э п ԓ ы т к у н э т _ м а й ы н ԓ я к _ # _ ы н ӄ о _
ивнинэт нэмэ	н э м э _
ӄунԓеԓюнэ ԓыгэн ынкы нытынпычерӄэнат	ԓ ы г э н _ # _ н ы т ы н п ы ч е р ӄ э н а т _
эӄэԓьыт аны нырэԓиԓӄутръуӄинэт эӄэԓьыгинив наӄам эвыр чыкэевыԓьын орвэпы нэнарэрыԓьатӄэнат ченэтэрвэты	а н ы _ # _ # _ н а ӄ а м _ # _ ч ы к э е в ы ԓ ь ы н _ # _ н э н а р э р ы ԓ ь а т ӄ э н а т _ ч е н э т э р в э т ы _
наӄам ԓьук ныԓвавӄэнат ирвыт	ԓ ь у к _ # _ # _
аны ынкы наԓгэнмыткойвынат	ы н к ы _ н а ԓ г э н м ы т к о й в ы н а т _
эӄэԓьыт ӄунԓеԓюнэ мараврата гынтэвыԓьыт тиӈурэ нычеӈкайвыӄэнат нэмэ ынкы тэӈыткунинэт	ӄ у н ԓ е ԓ ю н э _ # _ # _ т и ӈ у р э _ # _ н э м э _ ы н к ы _ т э ӈ ы т к у н и н э т _
эӄэԓьыт ӄунԓеԓюнэ мараврата аԓымы тъэркинэӄэй ӄунԓеԓюн	ӄ у н ԓ е ԓ ю н э _ # _ # _ т ъ э р к и н э ӄ э й _ # _
мараврат ӄоныръым гагыттавъяԓенат	ӄ о н ы р ъ ы м _ г а г ы т т а в ъ я ԓ е н а т _
ӄунԓеԓюнэ таӈымыԓьо выятӄаат ынкы ӈэԓвыԓьу нагтатын	т а ӈ ы м ы ԓ ь о _ # _ # _ ӈ э ԓ в ы ԓ ь у _ # _
ярагты ынкы ӄутти анмыка рытъёттэ ӄаагтатыԓьо	ы н к ы _ # _ # _ # _ # _
нэԓгынэт ӈан оравэтԓьат ынвэр	ӈ а н _ о р а в э т ԓ ь а т _ ы н в э р _
ӄунԓеԓюргин ӈаԓвыԓьиӈын гэԓгимкэтԓин миӈкыри ӄун	ӈ а ԓ в ы ԓ ь и ӈ ы н _ г э ԓ г и м к э т ԓ и н _ м и ӈ к ы р и _ ӄ у н _
танԓымынӄо эмиткэйвык наӄам гамгаԓымынӄо	э м и т к э й в ы к _ # _ г а м г а ԓ ы м ы н ӄ о _
ныԓӄыритъюуӄин эӄэԓьэ ӄунԓеԓю ӄынвэр уйӈэ нъэԓгъи эӄэԓьыкэ аны	э ӄ э ԓ ь э _ ӄ у н ԓ е ԓ ю _ ӄ ы н в э р _ # _ # _ э ӄ э ԓ ь ы к э _ # _
ӄунԓеԓю ганӈэнайпыԓен нивӄин ԓюур	г а н ӈ э н а й п ы ԓ е н _ # _ # _
ӄоԓ ӄуԓиԓьэтгъи ӄԓявыԓ ынӄэн	ӄ у ԓ и ԓ ь э т г ъ и _ # _ # _
мотԓынтона ынӄо иквъи ӄунԓеԓю ытръэч ԓыгимиӈкы	ы н ӄ о _ и к в ъ и _ ӄ у н ԓ е ԓ ю _ # _ # _
варкын ивнин ӄунԓеԓюнэ уӄӄэмӄэй ынӄо уӄӄэмӄэйынэ ивнинэт	и в н и н _ # _ у ӄ ӄ э м ӄ э й _ # _ # _ # _
ынкъам мыныюмӈимык нанмынат ынӄэнат рымӈэвъёно	м ы н ы ю м ӈ и м ы к _ # _ ы н ӄ э н а т _ р ы м ӈ э в ъ ё н о _
ынӄо нымӈиӄин уӄӄэмӄэй нутэк ԓьоо нивӄин уӄӄэмӄэй ынкы нэмэ	н ы м ӈ и ӄ и н _ # _ н у т э к _ # _ # _ # _ # _ # _
мытрэмӈигъэ ынкъым вэчьым	ы н к ъ ы м _ в э ч ь ы м _
мытрэԓьуӈын мотԓынто ыныкит мытранмыӈын майӈывопӄы вэчьым ӄун мытрэԓьуӈын мотԓынто ынӄо	м о т ԓ ы н т о _ ы н ы к и т _ м ы т р а н м ы ӈ ы н _ # _ # _ ӄ у н _ м ы т р э ԓ ь у ӈ ы н _ # _ ы н ӄ о _
пԓыткугъэт мыӈик аны	м ы ӈ и к _ а н ы _
ӈан гэмгутыԓеԓинэт ԓыгэн	г э м г у т ы ԓ е ԓ и н э т _ # _
ӄооӈ миӈкыри ръаянраӈаеты ымтыԓяӈэт ныръэтгэтаӄэн	м и ӈ к ы р и _ р ъ а я н р а ӈ а е т ы _ # _ н ы р ъ э т г э т а ӄ э н _
ирэпиӄытъым наӄам ытԓён эԓгаргаканъёԓьын ԓюур ирэпиӄытъым иквъи вэчьым ӄун ынӄэн уӄӄэмӄэй	н а ӄ а м _ ы т ԓ ё н _ э ԓ г а р г а к а н ъ ё ԓ ь ы н _ # _ и р э п и ӄ ы т ъ ы м _ # _ в э ч ь ы м _ # _ ы н ӄ э н _ у ӄ ӄ э м ӄ э й _
нивӄин вынэатав ԓыгэн ынкэгйит мынԓеркын 	в ы н э а т а в _ # _ ы н к э г й и т _ м ы н ԓ е р к ы н _ # _
эпԓеэн ръэӈэй ынӄэн аны	р ъ э ӈ э й _ # _ а н ы _
нымгутыԓеӄинэт атав	а т а в _
ԓыгэн ынкэгйит ԓюур	ы н к э г й и т _ ԓ ю у р _
ӄэгԓынангэр вытрэтгъи янраӈагчыӈын	в ы т р э т г ъ и _ # _
ынкэсӄыкым нывытрэтӄин ӄынур майӈыпырӄаквыԓгын 	н ы в ы т р э т ӄ и н _ ӄ ы н у р _ м а й ӈ ы п ы р ӄ а к в ы ԓ г ы н _ # _
ӄытԓыги майӈывопӄачгын ынкэгиӈкы рэвиквъэт ынӄэн майӈыянраӈайгэӈкы	м а й ӈ ы в о п ӄ а ч г ы н _ # _ р э в и к в ъ э т _ ы н ӄ э н _ м а й ӈ ы я н р а ӈ а й г э ӈ к ы _
ынӄо эквэтгъэт ӈэнри ӈэйыттэтгъэт	э к в э т г ъ э т _ ӈ э н р и _ # _
ӈыроргарэ	
ирэпиӄытъым уӄӄэмӄэй ынкъам ӄунԓеԓю	у ӄ ӄ э м ӄ э й _ ынкъам _ # _
нычамэттаӄэн вопӄайӈын ӄынвэр нэԓгинэймэвын ынкы	в о п ӄ а й ӈ ы н _ ӄ ы н в э р _ н э ԓ г и н э й м э в ы н _ # _
ытԓёнайӈын нытԓытвачгатӄэн ӄынур пырӄаквыԓгычгын ԓюур нэтиӈутчиргъэн ӈыронԓяӈо	н ы т ԓ ы т в а ч г а т ӄ э н _ ӄ ы н у р _ п ы р ӄ а к в ы ԓ г ы ч г ы н _ # _ н э т и ӈ у т ч и р г ъ э н _ # _
ынкы нэтэӈкыргун вопӄайӈын ынӄо	н э т э ӈ к ы р г у н _ # _ ы н ӄ о _
нэнкэвчитчевын ӈайӄаԓетԓы нэныпкирэтгъэн ярак нэнвэнӈын	ӈ а й ӄ а ԓ е т ԓ ы _ н э н ы п к и р э т г ъ э н _ я р а к _ # _
ӈэвысӄэтэ ынӄо ивнинэт уӄӄэмӄэйынэ гэмӈиԓин уӄӄэмӄэй энмэн	ы н ӄ о _ # _ у ӄ ӄ э м ӄ э й ы н э _ # _ у ӄ ӄ э м ӄ э й _ э н м э н _
йъэԓыги ныӄуӈычгэтӄин нинивӄин ӄунԓеԓюнэ энмэч эӄыԓпэ ӄырэԓьуӈыркын мотԓынто ынӄо	н ы ӄ у ӈ ы ч г э т ӄ и н _ # _ ӄ у н ԓ е ԓ ю н э _ # _ # _ ӄ ы р э ԓ ь у ӈ ы р к ы н _ # _ ы н ӄ о _
уӄӄэмӄэй иквъи ынӄэн	и к в ъ и _ # _
нымным мытрамӈыԓёйвыӈын ӄоԓ ынкэкин оравэтԓьан ытръэч ӄун нэмэԓым нотасӄычыковты ваԓьыраԓьыт чамъам мытрэԓьуӈынэт ынӄо пԓыткуй вэтгавкы уӄӄэмӄэй ӄунԓеԓю	м ы т р а м ӈ ы ԓ ё й в ы ӈ ы н _ # _ ы н к э к и н _ # _ # _ # _ н э м э ԓ ы м _ # _ # _ # _ м ы т р э ԓ ь у ӈ ы н э т _ # _ п ԓ ы т к у й _ # _ у ӄ ӄ э м ӄ э й _ ӄ у н ԓ е ԓ ю _
гивԓин ынӄо ръэйвэтгъэт ынкъам мууԓӄытгъэт	ы н ӄ о _ # _ # _ м у у ԓ ӄ ы т г ъ э т _
нэмэ гэмгутыԓеԓьэтԓинэт котчой ныянрагакаӈыԓьатӄэнат ӈыроргарэ ирэпиӄытъым	г э м г у т ы ԓ е ԓ ь э т ԓ и н э т _ # _ н ы я н р а г а к а ӈ ы ԓ ь а т ӄ э н а т _ ӈ ы р о р г а р э _ и р э п и ӄ ы т ъ ы м _
ӄунԓеԓю уӄӄэмӄэй ирэпиӄытъым	у ӄ ӄ э м ӄ э й _ # _
нэмэ ныёпыԓӄэвыԓьатӄэн тэнԓымынкыри тыԓяма нэмэ ивнинэт тумгыт нивӄин уӄӄэмӄэй ныянотӄэн ирэпиӄытъым ԓюур	н ы ё п ы ԓ ӄ э в ы ԓ ь а т ӄ э н _ # _ т ы ԓ я м а _ # _ # _ т у м г ы т _ н и в ӄ и н _ # _ # _ # _ ԓ ю у р _
вай пыкиргъэт ӄэгԓынангэр	п ы к и р г ъ э т _ # _
ынкы нытваӄэн тытыԓ нотасӄычыкогты	н ы т в а ӄ э н _ т ы т ы ԓ _ # _
ӄынур имчьэчукин ивнинэт	и м ч ь э ч у к и н _ # _
ӄунԓеԓюнэ гапэрӄытваԓен ӄунԓеԓю наӄам	г а п э р ӄ ы т в а ԓ е н _ # _ н а ӄ а м _
эԓгарӄааԓьын ынин	ы н и н _
гакаӈӄор эмъаԓвэнӄор ныԓгининъыӄин	э м ъ а ԓ в э н ӄ о р _ н ы ԓ г и н и н ъ ы ӄ и н _
наӄам майӈыԓеӈгыргыԓьын	м а й ӈ ы ԓ е ӈ г ы р г ы ԓ ь ы н _
ынин таӈымыԓьэты ниԓгыӄин	т а ӈ ы м ы ԓ ь э т ы _ # _
ӄунԓеԓюн увик миӈкыри ӄун эԓгувтычгыԓьын эԓгыӄонагԓьан	у в и к _ # _ # _ э ԓ г у в т ы ч г ы ԓ ь ы н _ # _
иԓгыԓиԓьын ԓыгэн ӄун ымыԓьэты ниԓгыӄин ынин орвоор	ԓ ы г э н _ ӄ у н _ ы м ы ԓ ь э т ы _ # _ # _ # _
эвыр ӄооԓгыт ԓюур аатчеӄӄай	ӄ о о ԓ г ы т _ # _ а а т ч е ӄ ӄ а й _
ӈытогъэ янор эмԓевыт рынтоӈаннэн	я н о р _ # _ # _
тэнԓымынкыри нытԓепыткуԓьэтӄин ынӄо	н ы т ԓ е п ы т к у ԓ ь э т ӄ и н _ # _
ӄынвэр ымыԓьэты увик рынтоӈаннэн	ы м ы ԓ ь э т ы _ у в и к _ р ы н т о ӈ а н н э н _
ынӄо ӈытосӄычатгъэ таӈванэван ныԓьунин атчытваԓьын	ӈ ы т о с ӄ ы ч а т г ъ э _ # _ н ы ԓ ь у н и н _ # _
ӄунԓеԓю эчги	э ч г и _
ӈытосӄычатгъэ	
аатчеӄӄай пэнрысӄычаннэн	п э н р ы с ӄ ы ч а н н э н _
ытԓён ӄунԓеԓюнэ аны	ӄ у н ԓ е ԓ ю н э _ # _
гыттакавӄооԓгиӈа гинэгнинтыԓин ӄунԓеԓюнэ ынык	г и н э г н и н т ы ԓ и н _ ӄ у н ԓ е ԓ ю н э _ ы н ы к _
гиӈкы	
рирэннин ԓюур ынӄэн	ԓ ю у р _ ы н ӄ э н _
аԓякватыткынык	
аԓякват 	_
ӈан орвывынгыргык	о р в ы в ы н г ы р г ы к _
рывоԓватытваԓьын ӈан риивтэгнык	ӈ а н _ р и и в т э г н ы к _
ынӄэн ынкъам	ы н к ъ а м _
ынкы рирэннин	р и р э н н и н _
ынӄо пиринин томгэнырыкы рыԓьэтэннин	п и р и н и н _ # _ # _
ынкы намӈыԓёйвын	н а м ӈ ы ԓ ё й в ы н _
ванэван ымы ночнэнат	ы м ы _ н о ч н э н а т _
миӈкыри ӄун	ӄун _
амайыԓгавкы аатчеӄӄай нэтэнринӈынъюн	а а т ч е ӄ ӄ а й _ н э т э н р и н ӈ ы н ъ ю н _
ынӄэн пэрэёӄай ынкъам намӈыԓён нэмэ ӄынвэр пыӈыԓтэԓгъэ ытԓёнаӄай нивӄин ынраӄым	п э р э ё ӄ а й _ # _ н а м ӈ ы ԓ ё н _ # _ ӄ ы н в э р _ п ы ӈ ы ԓ т э ԓ г ъ э _ # _ н и в ӄ и н _ ы н р а ӄ ы м _
иам ԓыгэн ӄун ныԓгиниквыӄин гэтэйкыԓин энмычгын ыныграк камԓеԓы	ԓ ы г э н _ # _ н ы ԓ г и н и к в ы ӄ и н _ г э т э й к ы ԓ и н _ # _ # _ к а м ԓ е ԓ ы _
иӈӄун мэӈин эвнэԓӄыткэ нитгъэн	м э ӈ и н _ э в н э ԓ ӄ ы т к э _ # _
ынӄо игыр ԓьэԓеӈкы ынраӄ гимԓыттъивыԓин энмээм ынӄэным	и г ы р _ # _ # _ # _ # _ ы н ӄ э н ы м _
энмычгын гатарӄойвэнӈачгатԓен таӈэтъо таӈъаӄаттаты гэнъэтԓин ынӄо пԓыткуй пыӈыԓтэԓык	г а т а р ӄ о й в э н ӈ а ч г а т ԓ е н _ т а ӈ э т ъ о _ т а ӈ ъ а ӄ а т т а т ы _ # _ ы н ӄ о _ п ԓ ы т к у й _ # _
ӄунԓеԓюнэ ивнин ынӄо ивнинэт	и в н и н _ ы н ӄ о _ и в н и н э т _
тумгыт ӄунԓеԓюнэ ынӄо ӄытгъи ынръа ӈан гаԓгэчаӈыттатчаԓенат	ӄ у н ԓ е ԓ ю н э _ # _ # _ ы н р ъ а _ # _ г а ԓ г э ч а ӈ ы т т а т ч а ԓ е н а т _
ивнинэт ӄунԓеԓюнэ нивӄинэт ытри	ӄ у н ԓ е ԓ ю н э _ # _ # _
наӄам ӄунԓеԓю ныԓгэнанӈэнаӄэн гатваԓен тэӈвэнԓыги ԓёӈытва нынтыӄин	ӄ у н ԓ е ԓ ю _ # _ # _ т э ӈ в э н ԓ ы г и _ # _ н ы н т ы ӄ и н _
ынӄо ивнинэт ӄунԓеԓюнэ ынӈатаԓ ымы мытратвыгыт эвыр	и в н и н э т _ ӄ у н ԓ е ԓ ю н э _ # _ # _ # _ # _
ранмыӈыткы мотԓынто эчги ынӈин	м о т ԓ ы н т о _ э ч г и _ ы н ӈ и н _
ивыпԓыткук ынӄэнат ӄунԓеԓю ганӈэнайпыԓен ынкъам гантосӄычатԓен пойгын	ы н ӄ э н а т _ # _ # _ # _ # _ # _
пиринин ынӄо ярачыкогты пиӈкугъи ынкы	ы н ӄ о _ я р а ч ы к о г т ы _ # _ # _
тымыткойвынэнат таӈымыԓьо ынӄо ӈытогъэ аатчеӄӄай ивнин ӄунԓеԓюнэ	т а ӈ ы м ы ԓ ь о _ # _ # _ а а т ч е ӄ ӄ а й _ # _ ӄ у н ԓ е ԓ ю н э _
энмэч моогты	м о о г т ы _
ӄыԓӄытги ынкъам ӄавэръэпыгэ	ы н к ъ а м _ ӄ а в э р ъ э п ы г э _
аатчеӄӄай ӄытгъи наӄам иръычвыткыԓьин уйӈэ ԓыгэн ӄун ӄэтывъэӈӈоԓьыӄай ынкъам пыкиргъи	ӄ ы т г ъ и _ н а ӄ а м _ # _ # _ ԓ ы г э н _ # _ ӄ э т ы в ъ э ӈ ӈ о ԓ ь ы ӄ а й _ # _ п ы к и р г ъ и _
муук ӄоныръым нэмэ ирэпиӄытъымынэ	ӄ о н ы р ъ ы м _ н э м э _ # _
гэнԓьэтэтԓин нанавэръэпатъёгъан ԓыгитэӈэвиръэ ынӄо эквэтгъэт нэмэ ынкэгйит аны ӄынвэр вуԓӄытвий	н а н а в э р ъ э п а т ъ ё г ъ а н _ # _ ы н ӄ о _ э к в э т г ъ э т _ н э м э _ ы н к э г й и т _ а н ы _ # _ в у ԓ ӄ ы т в и й _
ԓюур ынкы эмԓыттъэнмиӈын нэԓьун ӄэгԓынангэт ынӈин ваԓьын гэтэйкыԓин	ы н к ы _ # _ # _ ӄ э г ԓ ы н а н г э т _ # _ в а ԓ ь ы н _ г э т э й к ы ԓ и н _
пыкиргъэт ынкы ԓыгэн	ы н к ы _ ԓ ы г э н _
гыргоԓягты ныгитэӄин наӄам	н ы г и т э ӄ и н _ # _
вусӄымчыку мачванэван нывытрэтын тарӄойвэйӈын ынкы ӄэйыӄын чимгьугъи тумгэӄэй ӄунԓеԓю нивӄин миӈкыри мынынтын ынӄо ивнин	м а ч в а н э в а н _ # _ т а р ӄ о й в э й ӈ ы н _ ы н к ы _ ӄ э й ы ӄ ы н _ ч и м г ь у г ъ и _ # _ ӄ у н ԓ е ԓ ю _ # _ # _ м ы н ы н т ы н _ ы н ӄ о _ и в н и н _
ӄунԓеԓюнэ ирэпиӄытъым ынӄо	и р э п и ӄ ы т ъ ы м _ # _
гэквэтԓин ирэпиӄытъым нэмэ пыкиргъи	и р э п и ӄ ы т ъ ы м _ н э м э _ п ы к и р г ъ и _
ирэпиӄытъым аԓваԓьэнаръэтгыпы	а ԓ в а ԓ ь э н а р ъ э т г ы п ы _
ивнин гыттэпычьын маравраткэн ынӄо кыԓгытвынин	г ы т т э п ы ч ь ы н _ # _ # _ к ы ԓ г ы т в ы н и н _
ынин эԓгар эмъаԓвэнӄор наӄам майӈыԓьэӈгыргыԓьын эвыр	э ԓ г а р _ # _ # _ м а й ӈ ы ԓ ь э ӈ г ы р г ы ԓ ь ы н _ # _
нирвыӄинэт ынин ԓьэӈгыргыт ӄаӈаэвԓявэԓгиӈын рырыткунин	ы н и н _ ԓ ь э ӈ г ы р г ы т _ # _ р ы р ы т к у н и н _
ынкъам ръаратвавэԓнэн эмъаԓвэнӄор ынӄо чигԓемнин эмъаԓвэнӄор аны ԓыгэн эмъаԓвэнӄааӄай	р ъ а р а т в а в э ԓ н э н _ # _ ы н ӄ о _ ч и г ԓ е м н и н _ # _ а н ы _ ԓ ы г э н _ э м ъ а ԓ в э н ӄ а а ӄ а й _
гавэԓёвъяԓгыткоръэԓяԓен	
гыргоԓягты ԓыгэн таӈамԓьэӈгырга ныкэӈунэӈэткуӄин	ԓ ы г э н _ т а ӈ а м ԓ ь э ӈ г ы р г а _ # _
гыргоԓягты тыԓяма ԓыгэн ытръэч	т ы ԓ я м а _ # _ # _
яаԓгыткат ныкэнчиӄыткуӄинэт ӄуйвик яноткэнатым ымы таӈванэван нытрунэт	н ы к э н ч и ӄ ы т к у ӄ и н э т _ ӄ у й в и к _ я н о т к э н а т ы м _ ы м ы _ т а ӈ в а н э в а н _ # _
ӄуйвик	
ԓюур ынкэсӄэтгъи эԓгар эмъаԓвэнӄор	ы н к э с ӄ э т г ъ и _ # _ э м ъ а ԓ в э н ӄ о р _
ынко рэмыннуӈгъи этын	р э м ы н н у ӈ г ъ и _ э т ы н _
ынин тумгэӄэй ӄунԓеԓю ынӄо	т у м г э ӄ э й _ # _ # _
гиԓгыйиквиԓин ӄунԓеԓю гыргоԓягты эмъаԓвэӄааӄайым	ӄ у н ԓ е ԓ ю _ г ы р г о ԓ я г т ы _ # _
ынкэсӄык ныкытъыматӄэн ынкъым тинунин	н ы к ы т ъ ы м а т ӄ э н _ ы н к ъ ы м _ т и н у н и н _
ынкасӄэты этын эмъаԓвэнӄаата ынкы	э т ы н _ э м ъ а ԓ в э н ӄ а а т а _ # _
таӈэтъо гакоргавԓен ӄунԓеԓю ынӄо нэнайӈоӄэн	г а к о р г а в ԓ е н _ # _ # _ # _
ынкэсӄык эмъаԓвэнӄор миӈкыри	э м ъ а ԓ в э н ӄ о р _ м и ӈ к ы р и _
ӄун амкоргава	а м к о р г а в а _
гакоргавԓен ӄунԓеԓю ынӄо нэнайӈоӄэн ынкэсӄык эмъаԓвэнӄор миӈкыри ӄун	ӄ у н ԓ е ԓ ю _ # _ # _ # _ э м ъ а ԓ в э н ӄ о р _ м и ӈ к ы р и _ ӄ у н _
амкоргава ынӄо тиӈунинэт тумгыт ынкъам	ы н ӄ о _ т и ӈ у н и н э т _ # _ ынкъам _
раԓегъат ԓыгэн эвтыԓягты	ԓ ы г э н _ э в т ы ԓ я г т ы _
амыным эвын ынкы нытвачгатӄэн мотԓынтон ярайӈын	э в ы н _ ы н к ы _ н ы т в а ч г а т ӄ э н _ # _ я р а й ӈ ы н _
эвын ныԓгэнымайыӈӄэначгын	н ы ԓ г э н ы м а й ы ӈ ӄ э н а ч г ы н _
вынэ ныкитэ вусӄымчыку	н ы к и т э _ # _
пыкиргъэт ынкы	ы н к ы _
ратагнык ӄунԓеԓюнэ чиниткин эвторвыӄай	ӄ у н ԓ е ԓ ю н э _ ч и н и т к и н _ # _
ратчаннэн ынкъам ыръэ нэнаркыпчыткоӄэнат вивтыт ԓюур рай кыявычгатгъэ мотԓынтойӈын	ы н к ъ а м _ ы р ъ э _ # _ в и в т ы т _ ԓ ю у р _ # _ к ы я в ы ч г а т г ъ э _ # _
нивӄин ӄунԓеԓюнэ нинивӄин энмэч эӄыԓпэ ӄынтогэ вай	ӄ у н ԓ е ԓ ю н э _ # _ э н м э ч _ # _ ӄ ы н т о г э _ # _
мытъатчаркынэгыт еп	е п _
тыкынкэргыпатыркын вынэ	в ы н э _
нэнаԓгэнтэрӈыръовӄэнат ынин нэнэнэт ӄытԓыгъим	ы н и н _ н э н э н э т _ ӄ ы т ԓ ы г ъ и м _
нэнатынпычерӄэнат чиниткин	ч и н и т к и н _
эккэӄэгти ивнин	и в н и н _
ӄунԓеԓюнэ эӄыԓпэ аны	э ӄ ы ԓ п э _ # _
ӄынтогэ атчавооргэгыт еп ӈэвъэн	а т ч а в о о р г э г ы т _ # _ ӈ э в ъ э н _
кэргыпыркын ӄытԓыгъим	ӄ ы т ԓ ы г ъ и м _
	
тымыркынэн эчги ынӄэн тымыткопԓытконэнат эккэӄэгти	э ч г и _ ы н ӄ э н _ # _ # _
пԓыткугъи ченэтрайыръытагэнӈыԓьатык ԓюур	ч е н э т р а й ы р ъ ы т а г э н ӈ ы ԓ ь а т ы к _ # _
гыргоԓягты пэӈкочгатгъэ мотԓынтойӈын	п э ӈ к о ч г а т г ъ э _ # _
рынооргык ӄачайпы рыранэн	ӄ а ч а й п ы _ р ы р а н э н _
рэтэм ынкъам пиӈкугъи	ы н к ъ а м _ п и ӈ к у г ъ и _
ынӄоры гапойгыма нутэсӄык иргъи ӄунԓеԓюӄэйынэ	г а п о й г ы м а _ # _ и р г ъ и _ # _
ынанчиӄай гапойгыма пэнрынэн аны гапойгыԓьатмаравԓенат ынкы	г а п о й г ы м а _ # _ а н ы _ г а п о й г ы ԓ ь а т м а р а в ԓ е н а т _ # _
ӄынвэр ԓюур	ԓ ю у р _
пойгыкэн пыԓвынтын эрэтгъи эмуттэ чит гапойгыԓьатԓен	п ы ԓ в ы н т ы н _ э р э т г ъ и _ э м у т т э _ # _ г а п о й г ы ԓ ь а т ԓ е н _
ӄэйыӄын ынӄо ӄунԓеԓюнэ мынгычвэтконэн уйӈэ амынгыка рытчынин	ы н ӄ о _ # _ # _ # _ а м ы н г ы к а _ # _
ынӄо	
пынԓёнэн ӄунԓеԓюнэ ыныкым танӈырат тумгу	ӄ у н ԓ е ԓ ю н э _ # _ # _ т у м г у _
нитӄинэт ынӄэнат гаймычьыԓьыт наӄам ымы ӈэԓвыԓьык ӄорагынрэтыԓьо нитӄинэт	ы н ӄ э н а т _ # _ н а ӄ а м _ ы м ы _ ӈ э ԓ в ы ԓ ь ы к _ # _ # _
ӈъочьыӄагтэ ытԓёным ныԓгитэӈычьэтӄин ныԓгинымэԓьэв нынымытваӄэн	ы т ԓ ё н ы м _ н ы ԓ г и т э ӈ ы ч ь э т ӄ и н _ # _ н ы н ы м ы т в а ӄ э н _
эвыр ынӄэн ӈэнри ныӄамэтвасӄэвӄэн	ы н ӄ э н _ ӈ э н р и _ н ы ӄ а м э т в а с ӄ э в ӄ э н _
гаймычьыԓьэты ынӄо	ы н ӄ о _
ӄунԓеԓюнэ ивнинэт	и в н и н э т _
тумгыт ӈэԓвыԓ	ӈ э ԓ в ы ԓ _
йытыйгот ӄынтыгыткы	ӄ ы н т ы г ы т к ы _
мачынан ынан чинит	ы н а н _ ч и н и т _
ӈэԓвыԓ нырэннин	н ы р э н н и н _
ынӄо ӄунԓеԓю	ӄ у н ԓ е ԓ ю _
танӈырагты	
ӄытгъи пыкиргъи	п ы к и р г ъ и _
танӈырак ивниэт	и в н и э т _
ӄунԓеԓюнэ ԓюур вай	ԓ ю у р _ # _
моогъат ырыткуԓьэтык ытри ӄонԓяԓёна ӄунԓеԓюнэ тытыԓ рыныманнэн	ы р ы т к у ԓ ь э т ы к _ ы т р и _ ӄ о н ԓ я ԓ ё н а _ # _ т ы т ы ԓ _ # _
ынкъам ԓыгэн ынкы	ԓ ы г э н _ ы н к ы _
нуԓвыӄин аны	а н ы _
ынкы ԓыгэн	ԓ ы г э н _
ярачыко ныԓӄэгнэвъюуӄин	н ы ԓ ӄ э г н э в ъ ю у ӄ и н _
ԓюур ытри	ы т р и _
тэӈъэмикэ нъэԓгъэт	н ъ э ԓ г ъ э т _
